名前	アドレス	都道府県
平山 完爾	hirayama_kanji@example.com	東京都
加瀬 光	kase_hikaru@example.com	奈良県
福田 千佳子	fukuda_chikako@example.com	千葉県
大矢 俊介	ooya_shunsuke@example.com	宮崎県
桜井 明慶	sakurai_akiyoshi@example.com	和歌山県
小平 早紀	kohira_saki@example.com	島根県
土屋 隆博	tsuchiya_takahiro@example.com	神奈川県
西原 小雁	nishihara_kogan@example.com	宮城県
布川 麻緒	fukawa_mao@example.com	東京都
藤野 美優	fujino_myuu@example.com	神奈川県
片瀬 妃里	katase_yuri@example.com	秋田県
中 しほり	naka_shihori@example.com	鹿児島県
草村 小百合	kusamura_sayuri@example.com	京都府
唐沢 夏希	karasawa_natsuki@example.com	青森県
大沼 隆之介	oonuma_ryuunosuke@example.com	宮城県
矢作 三郎	yahagi_saburou@example.com	広島県
笠原 涼子	kasahara_ryouko@example.com	埼玉県
小林 優	kobayashi_yuu@example.com	広島県
高見 莉沙	takami_risa@example.com	熊本県
石山 芳正	ishiyama_yoshimasa@example.com	大阪府
古田 薫	furuta_kaoru@example.com	福岡県
米山 亮	yoneyama_ryou@example.com	兵庫県
松島 仁	matsushima_jin@example.com	広島県
森下 貴嶺	morishita_takane@example.com	福井県
境 南朋	sakai_nao@example.com	山口県
宮沢 恵麻	miyazawa_ema@example.com	東京都
北川 さとみ	kitakawa_satomi@example.com	石川県
松澤 雅之	matsuzawa_masayuki@example.com	宮城県
中尾 亮	nakao_ryou@example.com	鹿児島県
熊倉 薫	kumakura_kaoru@example.com	北海道
青野 恵梨香	aono_erika@example.com	熊本県
永田 恵美	nagata_megumi@example.com	熊本県
余 佳乃	yo_yoshino@example.com	神奈川県
川井 莉央	kawai_rio@example.com	滋賀県
海野 俊二	umino_shunji@example.com	兵庫県
吉沢 麗奈	yoshizawa_rena@example.com	京都府
石渡 真帆	ishiwatari_maho@example.com	滋賀県
佐久間 景子	sakuma_keiko@example.com	千葉県
武藤 由樹	mutou_yuki@example.com	京都府
本間 栄一	honma_eiichi@example.com	秋田県
市川 みゆき	ichikawa_miyuki@example.com	奈良県
船橋 璃奈子	funabashi_rinako@example.com	愛知県
江口 みゆき	eguchi_miyuki@example.com	東京都
江崎 秀樹	ezaki_hideki@example.com	神奈川県
工藤 有起哉	kudou_yukiya@example.com	青森県
松田 綾女	matsuda_ayame@example.com	鳥取県
竹本 浩正	takemoto_hiromasa@example.com	東京都
門脇 翔	kadowaki_shou@example.com	千葉県
吉原 なつみ	yoshiwara_natsumi@example.com	福島県
南部 涼	nannbu_ryou@example.com	千葉県
三原 怜奈	mihara_reina@example.com	沖縄県
小松 友香	komatsu_tomoka@example.com	熊本県
植村 ジョージ	uemura_george@example.com	茨城県
合田 翔太	aida_shouta@example.com	大阪府
西口 里穂	nishiguchi_riho@example.com	新潟県
武 真奈美	take_manami@example.com	新潟県
及川 貴嶺	oikawa_takane@example.com	東京都
沢田 薫	sawada_kaoru@example.com	兵庫県
田川 翔	tagawa_shou@example.com	愛知県
小木 なつみ	ogi_natsumi@example.com	埼玉県
畠山 努	hatayama_tsutomu@example.com	愛媛県
長澤 芳正	nagasawa_yoshimasa@example.com	北海道
田村 竜也	tamura_tatsuya@example.com	兵庫県
西島 優	nishijima_yuu@example.com	神奈川県
木村 淳	kimura_atsushi@example.com	千葉県
今 隆之介	kon_ryuunosuke@example.com	北海道
大津 涼	ootsu_ryou@example.com	兵庫県
小菅 亮	kosuge_ryou@example.com	愛知県
秋葉 崇史	akiba_takashi@example.com	栃木県
高田 優	takada_yuu@example.com	新潟県
三沢 克実	misawa_katsumi@example.com	山口県
有賀 知史	ariga_tomofumi@example.com	東京都
秋葉 ひとり	akiba_hitori@example.com	長野県
池内 あや子	ikeuchi_ayako@example.com	青森県
鹿手袋 あや子	shikatebukuro_ayako@example.com	大阪府
横田 雅功	yokota_masatoshi@example.com	長崎県
矢島 えみ	yajima_emi@example.com	東京都
白川 淳子	shirakawa_atsuko@example.com	埼玉県
小沢 圭	ozawa_kei@example.com	福島県
古田 隆	furuta_takashi@example.com	山口県
長井 さゆり	nagai_sayuri@example.com	福岡県
千葉 研二	chiba_kenji@example.com	長野県
白井 遥	shirai_haruka@example.com	北海道
羽田 雅功	hada_masatoshi@example.com	神奈川県
赤羽 和久	akabane_kazuhisa@example.com	長野県
熊倉 だん吉	kumakura_dankichi@example.com	広島県
田淵 杏	tabuchi_ann@example.com	千葉県
矢野 芽以	yano_mei@example.com	大阪府
井村 美智子	imura_michiko@example.com	埼玉県
森山 めぐみ	moriyama_megumi@example.com	神奈川県
志水 勇	shimizu_yuu@example.com	香川県
関根 隆之介	sekine_ryuunosuke@example.com	北海道
赤坂 千佳子	akasaka_chikako@example.com	千葉県
井出 エリカ	ide_erika@example.com	宮城県
森本 隼士	morimoto_shunji@example.com	新潟県
関谷 七世	sekiya_nanase@example.com	新潟県
三田 英嗣	mita_hidetsugu@example.com	兵庫県
岩谷 三郎	iwatani_saburou@example.com	北海道
塚田 あさみ	tsukada_asami@example.com	東京都
柄本 一代	emoto_kazuyo@example.com	北海道
河原 サンタマリア	kawahara_stmaria@example.com	岡山県
杉本 そら	sugimoto_sora@example.com	福岡県
大久保 奈央	ookubo_nao@example.com	東京都
大沼 精児	oonuma_seiji@example.com	神奈川県
香川 寿明	kagawa_toshiaki@example.com	大分県
勝地 栄一	katsudi_eiichi@example.com	兵庫県
米沢 莉央	yonezawa_rio@example.com	兵庫県
榊原 正敏	sakakibara_masatoshi@example.com	岡山県
茂木 みゆき	mogi_miyuki@example.com	福岡県
板倉 直人	itakura_naoto@example.com	北海道
宮沢 さんま	miyazawa_sanma@example.com	岐阜県
小田 礼子	oda_reiko@example.com	千葉県
川野 菜摘	kawano_natsumi@example.com	秋田県
堀 三省	hori_sansei@example.com	石川県
工藤 竜也	kudou_tatsuya@example.com	埼玉県
吉川 ひとり	kikkawa_hitori@example.com	茨城県
松井 菜摘	matsui_natsumi@example.com	埼玉県
神崎 美月	kanzaki_miduki@example.com	大阪府
金子 璃奈子	kaneko_rinako@example.com	神奈川県
芳賀 美和子	haga_miwako@example.com	茨城県
岩井 一代	iwai_kazuyo@example.com	東京都
三橋 ジローラモ	mihashi_girolamo@example.com	東京都
沖 一徳	oki_ittoku@example.com	千葉県
塩沢 郁恵	shiozawa_ikue@example.com	神奈川県
沖田 貴嶺	okita_takane@example.com	滋賀県
片桐 薫	katagiri_kaoru@example.com	千葉県
小松 法嗣	komatsu_houshi@example.com	栃木県
石沢 咲	ishizawa_saki@example.com	埼玉県
岩永 メイサ	iwanaga_meisa@example.com	徳島県
中原 佑	nakahara_tasuku@example.com	奈良県
大坂 竜也	oosaka_tatsuya@example.com	茨城県
小原 光良	ohara_teruyoshi@example.com	静岡県
根岸 聡	negishi_satoshi@example.com	北海道
古川 みあ	furukawa_mia@example.com	東京都
浅田 未來	asada_mirai@example.com	福島県
寺島 博之	terajima_hiroyuki@example.com	北海道
水川 たかお	mizukawa_takao@example.com	長野県
河合 祐基	kawai_yuuki@example.com	福岡県
柳沢 一樹	yanagisawa_kazuki@example.com	鹿児島県
池上 紗季	ikegami_saki@example.com	岡山県
河田 基祐	kawata_kisuke@example.com	大阪府
根岸 真吾	negishi_shingo@example.com	埼玉県
滝口 芳正	takiguchi_yoshimasa@example.com	愛知県
奥村 未華子	okumura_mikako@example.com	愛媛県
児島 麗奈	kojima_rena@example.com	福岡県
吉原 彩	yoshiwara_aya@example.com	石川県
坂元 サンタマリア	sakamoto_stmaria@example.com	愛媛県
黒岩 広司	kuroiwa_kouji@example.com	香川県
益田 由樹	masuda_yuki@example.com	熊本県
桜田 希	sakurada_nozomi@example.com	東京都
浦野 勇一	urano_yuuichi@example.com	東京都
田村 ひろ子	tamura_hiroko@example.com	神奈川県
三船 麻緒	mifune_mao@example.com	宮崎県
安藤 隆太	anndou_ryuuta@example.com	福岡県
末吉 雅功	suekichi_masatoshi@example.com	福岡県
大村 知世	oomura_chise@example.com	千葉県
富永 一輝	tominaga_kazuki@example.com	大阪府
森島 景子	morishima_keiko@example.com	茨城県
鈴木 美優	suzuki_myuu@example.com	茨城県
加納 一輝	kanou_kazuki@example.com	三重県
多部 しぼり	tabe_shibori@example.com	千葉県
安 早織	yasu_saori@example.com	岡山県
小畑 希	obata_nozomi@example.com	栃木県
篠原 綾	shinohara_aya@example.com	愛知県
堀口 雅功	horiguchi_masatoshi@example.com	茨城県
杉本 美幸	sugimoto_miyuki@example.com	千葉県
岡山 真奈美	okayama_manami@example.com	愛知県
江崎 杏	ezaki_ann@example.com	福岡県
尾上 小百合	ogami_sayuri@example.com	香川県
三輪 祐一	miwa_yuuichi@example.com	青森県
末吉 恵梨香	suekichi_erika@example.com	奈良県
高木 雅之	takagi_masayuki@example.com	北海道
戸田 貴嶺	toda_takane@example.com	長野県
中里 美優	nakazato_myuu@example.com	愛媛県
三好 貴嶺	miyoshi_takane@example.com	兵庫県
新谷 隼士	araya_shunji@example.com	茨城県
ともさか 賢治	tomosaka_kenji@example.com	茨城県
小沢 洋介	ozawa_yousuke@example.com	兵庫県
福田 育子	fukuda_ikuko@example.com	大阪府
小林 徹	kobayashi_tooru@example.com	愛知県
山村 めぐみ	yamamura_megumi@example.com	埼玉県
丹野 樹里	tannno_juri@example.com	広島県
福永 優一	fukunaga_yuuichi@example.com	熊本県
五十嵐 薫	igarashi_kaoru@example.com	静岡県
白石 亮介	shiraishi_ryousuke@example.com	宮崎県
佐川 花緑	sagawa_karoku@example.com	富山県
柳家 悟志	yanagiya_satoshi@example.com	東京都
足立 真一	adachi_shinichi@example.com	長崎県
平田 礼子	hirata_reiko@example.com	福岡県
堀川 崇史	horikawa_takashi@example.com	千葉県
井沢 祐基	izawa_yuuki@example.com	東京都
中島 美幸	nakashima_miyuki@example.com	長野県
長澤 奈央	nagasawa_nao@example.com	神奈川県
上杉 あおい	uesugi_aoi@example.com	香川県
綾瀬 正敏	ayase_masatoshi@example.com	兵庫県
松岡 知史	matsuoka_tomofumi@example.com	長野県
合田 菜々美	aida_nanami@example.com	熊本県
小松 秀樹	komatsu_hideki@example.com	神奈川県
大平 利夫	oohira_toshio@example.com	北海道
上原 美里	uehara_miri@example.com	神奈川県
三井 里穂	mitsui_riho@example.com	茨城県
平 たかお	taira_takao@example.com	岐阜県
石丸 信吾	ishimaru_shingo@example.com	埼玉県
塩田 ひかり	shiota_hikari@example.com	愛知県
国分 信輔	kokubunn_shinsuke@example.com	静岡県
瀬戸 光	seto_hikaru@example.com	神奈川県
塩見 里穂	shiomi_riho@example.com	宮城県
福地 薫	fukuchi_kaoru@example.com	埼玉県
立花 れいな	tachibana_reina@example.com	神奈川県
山川 未來	yamakawa_mirai@example.com	北海道
堀 美佐子	hori_misako@example.com	宮城県
パンツェッタ 明	panzetta_akira@example.com	埼玉県
中沢 一	nakazawa_hajime@example.com	石川県
石黒 友香	ishiguro_tomoka@example.com	千葉県
小松 莉沙	komatsu_risa@example.com	兵庫県
早美 太朗	hayami_tarou@example.com	宮城県
飯塚 隆博	iiduka_takahiro@example.com	山口県
寺本 春樹	teramoto_haruki@example.com	北海道
山本 健	yamamoto_ken@example.com	青森県
石山 恵梨香	ishiyama_erika@example.com	福岡県
城咲 洋介	shirosaki_yousuke@example.com	東京都
大下 寿々花	ooshita_suzuka@example.com	千葉県
倉本 景子	kuramoto_keiko@example.com	大阪府
黒崎 真吾	kurosaki_shingo@example.com	神奈川県
葛山 礼子	katsurayama_reiko@example.com	大阪府
永瀬 七世	nagase_nanase@example.com	大阪府
鈴木 なつみ	suzuki_natsumi@example.com	大阪府
荒木 淳子	araki_atsuko@example.com	愛知県
森口 佳乃	moriguchi_yoshino@example.com	石川県
東 知史	higashi_tomofumi@example.com	岡山県
本間 正敏	honma_masatoshi@example.com	東京都
末吉 良介	suekichi_ryousuke@example.com	熊本県
小高 里奈	kodaka_rina@example.com	埼玉県
溝口 明	mizoguchi_akira@example.com	静岡県
森山 まさし	moriyama_masashi@example.com	埼玉県
笠原 扶樹	kasahara_motoki@example.com	山口県
平田 春樹	hirata_haruki@example.com	東京都
原田 信吾	harada_shingo@example.com	愛知県
小笠原 完爾	ogasawara_kanji@example.com	千葉県
坪井 和香	tsuboi_waka@example.com	香川県
多部 夏空	tabe_sora@example.com	滋賀県
白木 博明	shiraki_hiroaki@example.com	大阪府
綾瀬 由宇	ayase_yuu@example.com	京都府
丹野 満	tannno_mitsuru@example.com	青森県
菅澤 愛子	sugasawa_aiko@example.com	千葉県
米沢 雅之	yonezawa_masayuki@example.com	茨城県
水川 南朋	mizukawa_nao@example.com	千葉県
松尾 菜摘	matsuo_natsumi@example.com	愛知県
富山 美菜	tomiyama_mina@example.com	福岡県
上野 真吾	ueno_shingo@example.com	熊本県
黒谷 明宏	kurotani_akihiro@example.com	長崎県
佐久間 瞬	sakuma_shun@example.com	和歌山県
北村 亮	kitamura_ryou@example.com	神奈川県
長野 隆太	nagano_ryuuta@example.com	神奈川県
三浦 樹里	miura_juri@example.com	新潟県
横山 慶二	yokoyama_keiji@example.com	神奈川県
宇野 美智子	uno_michiko@example.com	東京都
三浦 直人	miura_naoto@example.com	静岡県
西谷 雅彦	nishiya_masahiko@example.com	愛知県
川島 育子	kawashima_ikuko@example.com	福岡県
千葉 涼	chiba_ryou@example.com	東京都
今川 育二	imagawa_ikuji@example.com	愛知県
遠藤 遥	enndou_haruka@example.com	奈良県
神保 功補	jinbo_kousuke@example.com	岡山県
小日向 夏空	kohinata_sora@example.com	福岡県
大畑 佳乃	oohata_yoshino@example.com	沖縄県
青木 由美子	aoki_yumiko@example.com	茨城県
北条 育二	houjou_ikuji@example.com	長野県
神木 りえ	kamiki_rie@example.com	群馬県
真鍋 染五郎	manabe_somegorou@example.com	大阪府
村岡 亜希	muraoka_aki@example.com	岩手県
荒井 洋介	arai_yousuke@example.com	神奈川県
板橋 亮	itabashi_ryou@example.com	福岡県
ト字 奈月	toji_natsuki@example.com	大阪府
角谷 小百合	kadotani_sayuri@example.com	栃木県
緒形 奈月	ogata_natsuki@example.com	福岡県
梅沢 竜也	umezawa_tatsuya@example.com	大阪府
立石 美佳	tachiishi_mika@example.com	秋田県
西原 哲平	nishihara_teppei@example.com	埼玉県
秋本 一樹	akimoto_kazuki@example.com	東京都
皆川 愛菜	minakawa_aina@example.com	静岡県
川原 結衣	kawahara_yui@example.com	熊本県
照井 真希	terui_maki@example.com	広島県
中田 聡	nakata_satoshi@example.com	沖縄県
尾崎 佳乃	ozaki_yoshino@example.com	栃木県
野上 樹里	nogami_juri@example.com	奈良県
星野 光	hoshino_hikaru@example.com	福岡県
吉川 美菜	yoshikawa_mina@example.com	兵庫県
伊丹 隆	itami_takashi@example.com	広島県
小川 かおり	ogawa_kaori@example.com	新潟県
秋山 瞳	akiyama_hitomi@example.com	愛知県
玉山 高史	tamayama_takashi@example.com	石川県
奥山 徹	okuyama_tooru@example.com	香川県
熊谷 一	kumagaya_hajime@example.com	北海道
丸田 結子	maruta_yuuko@example.com	愛知県
渡辺 光	watanabe_hikaru@example.com	東京都
大原 祐基	oohara_yuuki@example.com	青森県
大沼 惇	oonuma_atsushi@example.com	福岡県
薬師丸 努	yakushimaru_tsutomu@example.com	茨城県
渡部 正義	watabe_masayoshi@example.com	北海道
川崎 沙知絵	kawasaki_sachie@example.com	兵庫県
酒井 まさみ	sakai_masami@example.com	東京都
小沢 丈雄	ozawa_takeo@example.com	東京都
相馬 勇一	aiba_yuuichi@example.com	静岡県
有村 洋	arimura_you@example.com	東京都
青木 れいな	aoki_reina@example.com	香川県
田川 菜々美	tagawa_nanami@example.com	秋田県
芦屋 里穂	ashiya_riho@example.com	岐阜県
真田 豊	sanada_yutaka@example.com	北海道
加藤 郁恵	katou_ikue@example.com	北海道
山岡 圭	yamaoka_kei@example.com	岐阜県
佐藤 だん吉	satou_dankichi@example.com	山梨県
木村 真悠子	kimura_mayuko@example.com	千葉県
塩谷 そら	shioya_sora@example.com	東京都
高原 美佐	takahara_misa@example.com	神奈川県
瀬戸 由宇	seto_yuu@example.com	沖縄県
渡部 人志	watabe_hitoshi@example.com	兵庫県
渡辺 完爾	watanabe_kanji@example.com	大阪府
川中 美佐子	kawanaka_misako@example.com	愛知県
金井 大樹	kanai_hiroki@example.com	兵庫県
松田 小雁	matsuda_kogan@example.com	徳島県
澤田 建	sawada_ken@example.com	長野県
長谷 雄太	nagaya_yuuta@example.com	大阪府
阿井 草太	ai_souta@example.com	大阪府
小野 怜奈	ono_reina@example.com	神奈川県
新谷 敏和	araya_toshikazu@example.com	兵庫県
小出 景子	koide_keiko@example.com	神奈川県
菅沼 優一	suganuma_yuuichi@example.com	大阪府
平沢 真一	hirasawa_shinichi@example.com	宮崎県
生瀬 晴臣	namase_haruomi@example.com	新潟県
矢作 知史	yahagi_tomofumi@example.com	大阪府
宮脇 基祐	miyawaki_kisuke@example.com	佐賀県
稲田 禄郎	inada_rokurou@example.com	東京都
依田 光	yorita_hikaru@example.com	新潟県
大沼 一恵	oonuma_kadue@example.com	福岡県
海野 俊介	umino_shunsuke@example.com	鹿児島県
西沢 真吾	nishizawa_shingo@example.com	東京都
伊藤 涼子	itou_ryouko@example.com	埼玉県
高尾 京子	takao_kyouko@example.com	熊本県
本多 明慶	honnda_akiyoshi@example.com	香川県
大村 誠治	oomura_seiji@example.com	千葉県
今井 遥	imai_haruka@example.com	福岡県
岩本 まさみ	iwamoto_masami@example.com	栃木県
満島 みあ	mitsushima_mia@example.com	東京都
成海 雅彦	narumi_masahiko@example.com	東京都
新村 宏行	niimura_hiroyuki@example.com	福岡県
高原 智花	takahara_tomoka@example.com	大阪府
玉木 恵梨香	tamaki_erika@example.com	兵庫県
塚田 京子	tsukada_kyouko@example.com	静岡県
松崎 勝久	matsuzaki_katsuhisa@example.com	福岡県
鎌田 仁晶	kamata_hiroaki@example.com	鹿児島県
森岡 孝太郎	morioka_koutarou@example.com	新潟県
早美 勇介	hayami_yuusuke@example.com	兵庫県
笹原 明	sasahara_akira@example.com	愛媛県
亀井 莉央	kamei_rio@example.com	愛知県
金井 丈雄	kanai_takeo@example.com	奈良県
哀川 真悠子	aikawa_mayuko@example.com	愛知県
野沢 光臣	nozawa_mitsuomi@example.com	長崎県
立石 ジョージ	tachiishi_george@example.com	大阪府
大高 了	oodaka_ryou@example.com	埼玉県
大沼 サダヲ	oonuma_sadawo@example.com	北海道
菅沼 麻由子	suganuma_mayuko@example.com	東京都
藤崎 薫	fujisaki_kaoru@example.com	兵庫県
田島 明慶	tajima_akiyoshi@example.com	神奈川県
河本 樹里	koumoto_juri@example.com	静岡県
森井 高史	morii_takashi@example.com	鹿児島県
羽田 光良	hada_teruyoshi@example.com	福島県
小室 憲一	komuro_kenichi@example.com	高知県
田口 サンタマリア	taguchi_stmaria@example.com	愛知県
半田 仁	hannda_jin@example.com	岐阜県
福地 フミヤ	fukuchi_fumiya@example.com	福岡県
車 優	kuruma_yuu@example.com	神奈川県
加納 莉緒	kanou_rio@example.com	神奈川県
津田 麗奈	tsuda_rena@example.com	大阪府
沢井 基祐	sawai_kisuke@example.com	兵庫県
筧 有起哉	kakei_yukiya@example.com	三重県
片岡 佳乃	kataoka_yoshino@example.com	山形県
古賀 美佐子	koga_misako@example.com	島根県
滝 幸子	taki_sachiko@example.com	東京都
大友 莉沙	ootomo_risa@example.com	長野県
鹿手袋 努	shikatebukuro_tsutomu@example.com	千葉県
大熊 晋也	ookuma_shinya@example.com	京都府
松浦 隆之介	matsuura_ryuunosuke@example.com	愛知県
塚原 隆	tsukahara_takashi@example.com	広島県
ユースケ 未來	yusuke_mirai@example.com	愛知県
重松 高史	shigematsu_takashi@example.com	愛知県
富樫 洋	togashi_you@example.com	石川県
岩下 真悠子	iwashita_mayuko@example.com	愛媛県
飯田 妃里	iida_yuri@example.com	青森県
吉岡 菜々美	yoshioka_nanami@example.com	栃木県
上原 獅童	uehara_shidou@example.com	新潟県
大庭 ジローラモ	ooniwa_girolamo@example.com	神奈川県
日高 守	hidaka_mamoru@example.com	茨城県
竹中 明	takenaka_akira@example.com	神奈川県
篠崎 結子	shinozaki_yuuko@example.com	埼玉県
田川 豊	tagawa_yutaka@example.com	岐阜県
岡田 陽子	okada_youko@example.com	千葉県
黒田 徹	kurota_tooru@example.com	東京都
車 窈	kuruma_you@example.com	東京都
伊東 エリカ	itou_erika@example.com	大阪府
森谷 徹	moriya_tooru@example.com	福島県
上野 洋介	ueno_yousuke@example.com	奈良県
塩見 美和子	shiomi_miwako@example.com	北海道
野呂 努	noro_tsutomu@example.com	埼玉県
井川 隆之介	igawa_ryuunosuke@example.com	神奈川県
堀井 洋介	horii_yousuke@example.com	神奈川県
小玉 里穂	kodama_riho@example.com	東京都
大下 たかお	ooshita_takao@example.com	福岡県
寺井 浩太郎	terai_koutarou@example.com	福島県
北川 徹平	kitagawa_teppei@example.com	和歌山県
奥村 真奈美	okumura_manami@example.com	神奈川県
澤田 美智子	sawada_michiko@example.com	神奈川県
末永 美咲	suenaga_misaki@example.com	長野県
小原 美里	ohara_miri@example.com	新潟県
神崎 守	kanzaki_mamoru@example.com	福岡県
堀口 晃司	horiguchi_kouji@example.com	東京都
篠崎 コウ	shinozaki_kou@example.com	岡山県
江藤 だん吉	etou_dankichi@example.com	愛知県
白川 しぼり	shirakawa_shibori@example.com	三重県
芹沢 真奈美	serizawa_manami@example.com	埼玉県
藤村 敏也	fujimura_toshiya@example.com	北海道
安達 耕司	adachi_kouji@example.com	東京都
塚原 樹里	tsukahara_juri@example.com	北海道
板倉 圭	itakura_kei@example.com	香川県
田代 建	tashiro_ken@example.com	香川県
黒田 正義	kurota_masayoshi@example.com	静岡県
川添 里穂	kawazoe_riho@example.com	石川県
野中 佑	nonaka_tasuku@example.com	愛知県
砂川 窈	sunakawa_you@example.com	岐阜県
高島 哲平	takashima_teppei@example.com	兵庫県
高村 郁恵	takamura_ikue@example.com	茨城県
荒井 夏空	arai_sora@example.com	埼玉県
海野 法子	umino_noriko@example.com	千葉県
西 華子	nishi_hanako@example.com	福岡県
奥田 満	okuda_mitsuru@example.com	福島県
奥村 愛	okumura_ai@example.com	東京都
岩佐 圭	iwasa_kei@example.com	鹿児島県
松谷 恵梨香	matsutani_erika@example.com	大阪府
酒井 沙耶	sakai_saya@example.com	鹿児島県
加納 かおり	kanou_kaori@example.com	山口県
中根 里穂	nakane_riho@example.com	埼玉県
小坂 康文	kozaka_yasufumi@example.com	大分県
松尾 春樹	matsuo_haruki@example.com	神奈川県
大久保 なぎさ	ookubo_nagisa@example.com	大阪府
大河内 めぐみ	ookouchi_megumi@example.com	大阪府
杉下 怜奈	sugishita_reina@example.com	北海道
金田 信吾	kaneda_shingo@example.com	東京都
橋爪 直人	hashidume_naoto@example.com	大分県
土田 みあ	tsuchida_mia@example.com	岐阜県
島 禄郎	shima_rokurou@example.com	和歌山県
浅倉 みき	asakura_miki@example.com	石川県
瀬戸 美咲	seto_misaki@example.com	兵庫県
上田 明日	ueda_meibi@example.com	宮城県
小松 芽以	komatsu_mei@example.com	大阪府
徳永 恵美	tokunaga_megumi@example.com	茨城県
戸塚 たかお	toduka_takao@example.com	静岡県
藤村 達士	fujimura_tatsuhito@example.com	富山県
乾 コウ	inui_kou@example.com	埼玉県
真田 七世	sanada_nanase@example.com	神奈川県
岩井 あい	iwai_ai@example.com	岡山県
遠藤 寛	enndou_hiroshi@example.com	埼玉県
井村 昌代	imura_masayo@example.com	神奈川県
福士 ノブヒコ	fukushi_nobuhiko@example.com	栃木県
はしの 真悠子	hashino_mayuko@example.com	岐阜県
岩佐 愛子	iwasa_aiko@example.com	福岡県
小野 充則	ono_mitsunori@example.com	山口県
松田 あい	matsuda_ai@example.com	埼玉県
津田 たまき	tsuda_tamaki@example.com	大阪府
沢田 佑	sawada_tasuku@example.com	兵庫県
青柳 礼子	aoyagi_reiko@example.com	神奈川県
田上 咲	taue_saki@example.com	埼玉県
石山 洋介	ishiyama_yousuke@example.com	広島県
早坂 真帆	hayasaka_maho@example.com	福岡県
水口 洋介	mizuguchi_yousuke@example.com	京都府
仲村 由美子	nakamura_yumiko@example.com	高知県
細山 まみ	hosoyama_mami@example.com	北海道
秋本 雅之	akimoto_masayuki@example.com	福岡県
渡辺 敦	watanabe_atsushi@example.com	山形県
小久保 努	kokubo_tsutomu@example.com	東京都
田辺 美希	tanabe_miki@example.com	大阪府
岩村 未來	iwamura_mirai@example.com	宮城県
山根 由美子	yamane_yumiko@example.com	静岡県
福本 那奈	fukumoto_nana@example.com	山形県
石坂 輝信	ishizaka_akinobu@example.com	青森県
村田 一徳	murata_ittoku@example.com	茨城県
高崎 智花	takasaki_tomoka@example.com	福岡県
高梨 禄郎	takanashi_rokurou@example.com	神奈川県
小西 翔太	konishi_shouta@example.com	千葉県
上原 まさみ	uehara_masami@example.com	香川県
菅谷 璃子	sugaya_riko@example.com	広島県
桑原 健	kuwabara_ken@example.com	神奈川県
島 隆博	shima_takahiro@example.com	北海道
栗田 光	kurita_hikaru@example.com	京都府
臼井 染五郎	usui_somegorou@example.com	三重県
矢作 憲一	yahagi_kenichi@example.com	宮城県
パンツェッタ 友也	panzetta_tomoya@example.com	京都府
細井 七世	hosoi_nanase@example.com	神奈川県
松谷 米蔵	matsutani_yonezou@example.com	福岡県
福島 光臣	fukushima_mitsuomi@example.com	香川県
佐野 知世	sano_chise@example.com	兵庫県
笹川 新太	sasagawa_arata@example.com	長崎県
竹本 慎之介	takemoto_shinnosuke@example.com	神奈川県
岡村 一徳	okamura_ittoku@example.com	新潟県
岩谷 碧海	iwatani_ouga@example.com	北海道
八田 れいな	yatsuda_reina@example.com	山口県
田口 人志	taguchi_hitoshi@example.com	島根県
三宅 勝久	miyake_katsuhisa@example.com	兵庫県
大田 景子	oota_keiko@example.com	長野県
小杉 千佳子	kosugi_chikako@example.com	北海道
曽我 敏和	soga_toshikazu@example.com	福岡県
石丸 崇史	ishimaru_takashi@example.com	神奈川県
風間 勇	kazama_yuu@example.com	福島県
八十田 かおり	yasoda_kaori@example.com	茨城県
矢沢 あい	yazawa_ai@example.com	山梨県
竹本 竜也	takemoto_tatsuya@example.com	神奈川県
芳賀 莉沙	haga_risa@example.com	愛知県
畠山 丈雄	hatayama_takeo@example.com	東京都
今田 はるみ	imada_harumi@example.com	神奈川県
毛利 正義	mouri_masayoshi@example.com	愛知県
津川 奈央	tsugawa_nao@example.com	滋賀県
波多野 莉緒	hatano_rio@example.com	東京都
長谷川 愛子	hasegawa_aiko@example.com	三重県
渡辺 翔子	watanabe_shouko@example.com	福井県
久米 満	kume_mitsuru@example.com	東京都
村松 崇史	muramatsu_takashi@example.com	鹿児島県
西尾 丈史	nishio_takeshi@example.com	神奈川県
田上 隆	taue_takashi@example.com	北海道
六角 妃里	rokkaku_yuri@example.com	滋賀県
米倉 光	yonekura_hikaru@example.com	大分県
小口 サンタマリア	oguchi_stmaria@example.com	静岡県
勝又 はるみ	katsumata_harumi@example.com	熊本県
野崎 勇一	nozaki_yuuichi@example.com	栃木県
井川 敏也	igawa_toshiya@example.com	愛知県
三橋 裕司	mihashi_yuuji@example.com	東京都
香椎 那奈	kashii_nana@example.com	大阪府
前原 たかお	maehara_takao@example.com	東京都
中尾 恵望子	nakao_emiko@example.com	福岡県
後藤 仁	gotou_jin@example.com	東京都
土谷 恵麻	tsuchiya_ema@example.com	宮崎県
荒木 みき	araki_miki@example.com	岩手県
村松 真悠子	muramatsu_mayuko@example.com	兵庫県
坂東 知世	banntou_chise@example.com	福岡県
浜田 勇一	hamada_yuuichi@example.com	北海道
内藤 知世	naitou_chise@example.com	滋賀県
沢 春樹	sawa_haruki@example.com	沖縄県
宮沢 真希	miyazawa_maki@example.com	兵庫県
平賀 怜奈	hiraga_reina@example.com	埼玉県
大場 たかお	ooba_takao@example.com	神奈川県
丹羽 ひとみ	tannba_hitomi@example.com	愛知県
宮野 サンタマリア	miyano_stmaria@example.com	秋田県
青木 幸平	aoki_kouhei@example.com	福岡県
亀山 草太	kameyama_souta@example.com	宮城県
米田 雅之	yoneda_masayuki@example.com	愛知県
太田 昌代	oota_masayo@example.com	大阪府
藤本 昴	fujimoto_subaru@example.com	秋田県
内田 礼子	uchida_reiko@example.com	新潟県
玉置 薫	tamaki_kaoru@example.com	東京都
山川 遥	yamakawa_haruka@example.com	千葉県
小池 瞳	koike_hitomi@example.com	福井県
坂東 季衣	banntou_toshie@example.com	愛知県
対馬 さとみ	tsushima_satomi@example.com	京都府
井川 満	igawa_mitsuru@example.com	新潟県
瀬戸 砂羽	seto_sawa@example.com	宮崎県
西谷 里奈	nishiya_rina@example.com	福島県
有馬 ジローラモ	arima_girolamo@example.com	和歌山県
守屋 さんま	moriya_sanma@example.com	北海道
北村 ちえみ	kitamura_chiemi@example.com	岐阜県
宮迫 綾	miyasako_aya@example.com	岡山県
田尻 翔太	tajiri_shouta@example.com	群馬県
木原 英嗣	kihara_hidetsugu@example.com	岩手県
菅 杏	suga_ann@example.com	埼玉県
谷川 小百合	tanikawa_sayuri@example.com	北海道
武藤 博之	mutou_hiroyuki@example.com	長崎県
山本 美佐子	yamamoto_misako@example.com	神奈川県
松岡 竜也	matsuoka_tatsuya@example.com	大阪府
乾 陽子	inui_youko@example.com	愛知県
高原 茜	takahara_akane@example.com	福岡県
宮原 由宇	miyahara_yuu@example.com	福岡県
平賀 慶二	hiraga_keiji@example.com	山口県
米沢 那奈	yonezawa_nana@example.com	静岡県
貫地谷 明	kanjiya_akira@example.com	愛知県
細谷 進	hosoya_susumu@example.com	兵庫県
森本 哲平	morimoto_teppei@example.com	富山県
亀山 彩	kameyama_aya@example.com	広島県
三木 コウ	miki_kou@example.com	福島県
細田 耕司	hosoda_kouji@example.com	千葉県
小谷 愛菜	kotani_aina@example.com	石川県
西脇 慶太	nishiwaki_keita@example.com	埼玉県
平岡 恭子	hiraoka_kyouko@example.com	千葉県
ト字 ヒロ	toji_hiro@example.com	岐阜県
村山 草太	murayama_souta@example.com	兵庫県
畑 直人	hatake_naoto@example.com	静岡県
岸田 涼	kishida_ryou@example.com	大阪府
大川 きみまろ	ookawa_kimimaro@example.com	宮城県
根本 小百合	nemoto_sayuri@example.com	石川県
熊井 花緑	kumai_karoku@example.com	滋賀県
芹沢 結衣	serizawa_yui@example.com	徳島県
瀬川 直人	segawa_naoto@example.com	東京都
岩田 文世	iwata_fumiyo@example.com	鹿児島県
宮原 由樹	miyahara_yuki@example.com	大阪府
高梨 景子	takanashi_keiko@example.com	大阪府
中西 夏空	nakanishi_sora@example.com	東京都
白鳥 光	shiratori_hikaru@example.com	三重県
神山 浩介	kamiyama_kousuke@example.com	静岡県
伊崎 陽子	isaki_youko@example.com	鹿児島県
ともさか 那奈	tomosaka_nana@example.com	神奈川県
松田 陽子	matsuda_youko@example.com	石川県
中野 啓介	nakano_keisuke@example.com	千葉県
高樹 了	takagi_ryou@example.com	東京都
仲村 崇史	nakamura_takashi@example.com	静岡県
比嘉 かおり	hiyoshi_kaori@example.com	福島県
川原 遥	kawahara_haruka@example.com	埼玉県
田中 啓介	tanaka_keisuke@example.com	愛媛県
福地 詩織	fukuchi_shiori@example.com	大分県
西沢 芳正	nishizawa_yoshimasa@example.com	群馬県
福山 茂樹	fukuyama_shigeki@example.com	佐賀県
柳 慢太郎	yanagi_mantarou@example.com	愛媛県
役所 一代	yakusho_kazuyo@example.com	福島県
重松 あや子	shigematsu_ayako@example.com	鹿児島県
角田 倫子	kadota_noriko@example.com	岐阜県
柳 雅彦	yanagi_masahiko@example.com	埼玉県
井手 京子	ide_kyouko@example.com	長野県
村瀬 あや子	murase_ayako@example.com	高知県
中園 あさみ	nakazono_asami@example.com	兵庫県
三田 結子	mita_yuuko@example.com	埼玉県
三村 智花	mimura_tomoka@example.com	静岡県
桜井 英嗣	sakurai_hidetsugu@example.com	三重県
岡 なぎさ	oka_nagisa@example.com	茨城県
芦屋 宏行	ashiya_hiroyuki@example.com	岡山県
小林 草太	kobayashi_souta@example.com	岩手県
八十田 ジョージ	yasoda_george@example.com	新潟県
金城 染五郎	kanashiro_somegorou@example.com	愛知県
宮内 鉄二	miyauchi_tetsuji@example.com	静岡県
真田 陽子	sanada_youko@example.com	神奈川県
菅澤 ひとみ	sugasawa_hitomi@example.com	群馬県
西尾 ひかり	nishio_hikari@example.com	沖縄県
柴田 菜摘	shibata_natsumi@example.com	千葉県
阪口 あさみ	sakaguchi_asami@example.com	和歌山県
増井 結衣	masui_yui@example.com	宮崎県
小町 大	komachi_masaru@example.com	北海道
野本 メイサ	nomoto_meisa@example.com	愛知県
小池 さとみ	koike_satomi@example.com	奈良県
武藤 一哉	mutou_kazuya@example.com	山梨県
野島 薫	nojima_kaoru@example.com	山口県
中尾 充則	nakao_mitsunori@example.com	千葉県
森川 知世	morikawa_chise@example.com	高知県
笹川 龍吉	sasagawa_ryuukichi@example.com	神奈川県
川井 莉緒	kawai_rio1@example.com	神奈川県
平尾 法嗣	hirao_houshi@example.com	鹿児島県
森田 惇	morita_atsushi@example.com	神奈川県
藤森 さんま	fujimori_sanma@example.com	東京都
黒川 洋介	kurokawa_yousuke@example.com	兵庫県
沢田 優一	sawada_yuuichi@example.com	神奈川県
大浦 栄一	ooura_eiichi@example.com	大阪府
大沢 季衣	oosawa_toshie@example.com	熊本県
美木 ちえみ	miki_chiemi@example.com	三重県
河村 誠一	kawamura_seiichi@example.com	熊本県
片山 将也	katayama_masaya@example.com	愛知県
木田 淳子	kida_atsuko@example.com	新潟県
西沢 哲平	nishizawa_teppei@example.com	鹿児島県
上野 夏希	ueno_natsuki@example.com	神奈川県
中里 愛子	nakazato_aiko@example.com	千葉県
三田 功補	mita_kousuke@example.com	山梨県
山本 美幸	yamamoto_miyuki@example.com	東京都
本山 裕次郎	honnyama_yuujirou@example.com	大阪府
町田 賢二	machida_kenji@example.com	宮崎県
樋口 朝香	higuchi_asaka@example.com	静岡県
園田 文世	sonoda_fumiyo@example.com	東京都
神山 華子	kamiyama_hanako@example.com	岡山県
福島 知世	fukushima_chise@example.com	千葉県
竹内 樹里	takeuchi_juri@example.com	北海道
古田 麻由子	furuta_mayuko@example.com	栃木県
斉藤 美智子	saitou_michiko@example.com	岩手県
田淵 くるみ	tabuchi_kurumi@example.com	福岡県
杉野 美嘉	sugino_mika@example.com	東京都
小泉 礼子	koizumi_reiko@example.com	愛知県
玉山 ちえみ	tamayama_chiemi@example.com	東京都
田淵 寿明	tabuchi_toshiaki@example.com	山形県
福島 窈	fukushima_you@example.com	愛媛県
杉原 美優	sugihara_myuu@example.com	大阪府
金城 聡	kanashiro_satoshi@example.com	山口県
野際 雅功	nogiwa_masatoshi@example.com	大阪府
七瀬 大	nanase_masaru@example.com	愛知県
村松 豊	muramatsu_yutaka@example.com	和歌山県
北野 聡	kitano_satoshi@example.com	群馬県
武 勇一	take_yuuichi@example.com	熊本県
目黒 華子	meguro_hanako@example.com	岡山県
藤澤 六郎	fujisawa_rokurou@example.com	茨城県
浜口 雅彦	hamaguchi_masahiko@example.com	愛知県
坂本 奈々	sakamoto_nana@example.com	愛知県
岩瀬 努	iwase_tsutomu@example.com	大分県
藤岡 亮	fujioka_ryou@example.com	山梨県
遠山 了	tooyama_ryou@example.com	東京都
矢島 育二	yajima_ikuji@example.com	山口県
布施 正敏	fuse_masatoshi@example.com	神奈川県
三船 サダヲ	mifune_sadawo@example.com	宮城県
橘 幸子	tachibana_sachiko@example.com	大阪府
深沢 隆太	fukazawa_ryuuta@example.com	千葉県
村上 知世	murakami_chise@example.com	東京都
小倉 えみ	ogura_emi@example.com	群馬県
沖田 隆之介	okita_ryuunosuke@example.com	千葉県
内田 あや子	uchida_ayako@example.com	群馬県
阿部 由宇	abe_yuu@example.com	東京都
甲斐 守	kai_mamoru@example.com	群馬県
樋口 直人	higuchi_naoto@example.com	佐賀県
徳永 陽子	tokunaga_youko@example.com	宮崎県
小口 ひとみ	oguchi_hitomi@example.com	香川県
柄本 ヒロ	emoto_hiro@example.com	東京都
久野 倫子	hisano_noriko@example.com	青森県
矢口 ひろみ	yaguchi_hiromi@example.com	愛知県
横川 貴美子	yokokawa_kimiko@example.com	東京都
後藤 璃奈子	gotou_rinako@example.com	岡山県
伊丹 小百合	itami_sayuri@example.com	大阪府
松田 哲平	matsuda_teppei@example.com	愛知県
石川 紗季	ishikawa_saki@example.com	沖縄県
伊丹 あや子	itami_ayako@example.com	和歌山県
福地 育子	fukuchi_ikuko@example.com	福岡県
深井 美佐	fukai_misa@example.com	新潟県
吉岡 真奈美	yoshioka_manami@example.com	神奈川県
土谷 亮介	tsuchiya_ryousuke@example.com	三重県
勝田 幸平	katsuda_kouhei@example.com	鹿児島県
宇多田 徹	utada_tohru@example.com	山梨県
木本 和久	kimoto_kazuhisa@example.com	神奈川県
大塚 愛	ootsuka_ai@example.com	福岡県
有田 七世	arita_nanase@example.com	北海道
西浦 さんま	nishiura_sanma@example.com	千葉県
山上 満	yamagami_mitsuru@example.com	大阪府
田淵 千佳子	tabuchi_chikako@example.com	福井県
下川 真吾	shimokawa_shingo@example.com	山口県
梅原 一輝	umehara_kazuki@example.com	青森県
倉田 洋介	kurata_yousuke@example.com	北海道
塚本 エリカ	tsukamoto_erika@example.com	大阪府
高岡 聡	takaoka_satoshi@example.com	東京都
深井 兼	fukai_ken@example.com	滋賀県
和田 真奈美	wada_manami@example.com	東京都
福田 慎之介	fukuda_shinnosuke@example.com	神奈川県
久野 竜也	hisano_tatsuya@example.com	新潟県
三村 美菜	mimura_mina@example.com	大阪府
前島 美幸	maejima_miyuki@example.com	熊本県
石本 かおり	ishimoto_kaori@example.com	神奈川県
織田 千夏	oda_chinatsu@example.com	島根県
村田 知史	murata_tomofumi@example.com	神奈川県
青木 瑠璃亜	aoki_ruria@example.com	京都府
宮地 孝太郎	miyaji_koutarou@example.com	香川県
富永 淳子	tominaga_atsuko@example.com	東京都
滝沢 知世	takizawa_chise@example.com	広島県
おかやま 浩介	okayama_kousuke@example.com	熊本県
菊地 ひとみ	kikuchi_hitomi@example.com	熊本県
長沢 ジョージ	nagasawa_george@example.com	宮崎県
石原 有海	ishihara_ami@example.com	北海道
藤 愛	fuji_ai@example.com	群馬県
多部 俊二	tabe_shunji@example.com	愛知県
井口 淳子	iguchi_atsuko@example.com	岡山県
磯野 晃司	isono_kouji@example.com	和歌山県
石田 美和子	ishida_miwako@example.com	熊本県
柏原 宏行	kashiwara_hiroyuki@example.com	和歌山県
新谷 栄一	araya_eiichi@example.com	広島県
仲田 景子	nakata_keiko@example.com	茨城県
三宅 優	miyake_yuu@example.com	東京都
山城 慢太郎	yamashiro_mantarou@example.com	茨城県
片平 なぎさ	katahira_nagisa@example.com	北海道
柳川 朝陽	yanagawa_asahi@example.com	富山県
三宅 砂羽	miyake_sawa@example.com	愛知県
大谷 六郎	ootani_rokurou@example.com	山形県
平良 昴	hirara_subaru@example.com	富山県
辻本 亜希	tsujimoto_aki@example.com	埼玉県
平野 莉緒	hirano_rio@example.com	熊本県
綾瀬 ひろみ	ayase_hiromi@example.com	東京都
木下 希	kinoshita_nozomi@example.com	富山県
芹沢 芽以	serizawa_mei@example.com	京都府
末永 だん吉	suenaga_dankichi@example.com	千葉県
栗田 希	kurita_nozomi@example.com	茨城県
永田 慎之介	nagata_shinnosuke@example.com	静岡県
薬師丸 未來	yakushimaru_mirai@example.com	山口県
上田 丈雄	ueda_takeo@example.com	新潟県
茂木 京子	mogi_kyouko@example.com	徳島県
少路 ケンイチ	shouji_kenichi@example.com	愛知県
吉本 染五郎	yoshimoto_somegorou@example.com	埼玉県
水口 れいな	mizuguchi_reina@example.com	福島県
長浜 あや子	nagahama_ayako@example.com	愛媛県
三枝 美幸	sannshi_miyuki@example.com	神奈川県
手塚 季衣	teduka_toshie@example.com	宮崎県
秋山 えみ	akiyama_emi@example.com	群馬県
岩井 照生	iwai_teruo@example.com	岡山県
田畑 雅之	tabata_masayuki@example.com	茨城県
藤井 仁晶	fujii_hiroaki@example.com	鳥取県
大和田 丈雄	oowada_takeo@example.com	東京都
戸田 右京	toda_ukyou@example.com	福岡県
川野 真希	kawano_maki@example.com	群馬県
永井 由美子	nagai_yumiko@example.com	茨城県
加藤 芽以	katou_mei@example.com	大阪府
増田 智花	masuda_tomoka@example.com	福井県
高沢 康文	takasawa_yasufumi@example.com	愛媛県
上野 はじめ	ueno_hajime@example.com	兵庫県
畠山 美幸	hatayama_miyuki@example.com	長野県
堀江 知世	horie_chise@example.com	鹿児島県
土屋 メイサ	tsuchiya_meisa@example.com	山口県
松岡 美佐子	matsuoka_misako@example.com	静岡県
高岡 法嗣	takaoka_houshi@example.com	茨城県
尾上 美紀	ogami_miki@example.com	大阪府
満島 りえ	mitsushima_rie@example.com	東京都
沢村 満	sawamura_mitsuru@example.com	神奈川県
横尾 隼士	yokoo_shunji@example.com	富山県
吉永 浩正	yoshinaga_hiromasa@example.com	埼玉県
小森 綾	komori_aya@example.com	愛知県
福本 友以乃	fukumoto_yuino@example.com	兵庫県
山内 三省	yamauchi_sansei@example.com	大阪府
梅田 茜	umeda_akane@example.com	福岡県
桜井 長利	sakurai_nagatoshi@example.com	兵庫県
角田 くるみ	kadota_kurumi@example.com	大阪府
平川 聡	hirakawa_satoshi@example.com	栃木県
落合 勝久	ochiai_katsuhisa@example.com	愛知県
西脇 隼士	nishiwaki_shunji@example.com	東京都
川井 染五郎	kawai_somegorou@example.com	大阪府
日野 禄郎	hino_rokurou@example.com	岐阜県
半田 達士	hannda_tatsuhito@example.com	愛知県
小高 知世	kodaka_chise@example.com	広島県
稲垣 大五郎	inagaki_daigorou@example.com	千葉県
石原 陽子	ishihara_youko@example.com	鹿児島県
井上 薫	inoue_kaoru@example.com	福岡県
秋山 豊	akiyama_yutaka@example.com	沖縄県
福地 光良	fukuchi_teruyoshi@example.com	宮城県
工藤 ケンイチ	kudou_kenichi@example.com	千葉県
小杉 洋介	kosugi_yousuke@example.com	宮崎県
赤松 フミヤ	akamatsu_fumiya@example.com	兵庫県
中尾 亜希	nakao_aki@example.com	岡山県
沢 翔	sawa_shou@example.com	千葉県
堀田 貴美子	hotta_kimiko@example.com	石川県
奥 朝香	oku_asaka@example.com	和歌山県
菊田 俊介	kikuta_shunsuke@example.com	埼玉県
野島 サンタマリア	nojima_stmaria@example.com	埼玉県
三浦 菊生	miura_kikuo@example.com	岡山県
河原 哲平	kawahara_teppei@example.com	石川県
西原 米蔵	nishihara_yonezou@example.com	群馬県
関根 建	sekine_ken@example.com	熊本県
下村 信吾	shimomura_shingo@example.com	兵庫県
石田 みあ	ishida_mia@example.com	埼玉県
田尻 まさし	tajiri_masashi@example.com	広島県
柳 育二	yanagi_ikuji@example.com	愛知県
森本 研二	morimoto_kenji@example.com	岡山県
青山 未華子	aoyama_mikako@example.com	大阪府
小西 たまき	konishi_tamaki@example.com	福岡県
瀬戸内 芳正	setouchi_yoshimasa@example.com	和歌山県
岡 有起哉	oka_yukiya@example.com	千葉県
高柳 博明	takayanagi_hiroaki@example.com	東京都
落合 恵子	ochiai_keiko@example.com	東京都
三橋 希	mihashi_nozomi@example.com	栃木県
小木 美紀	ogi_miki@example.com	埼玉県
並木 エリカ	namiki_erika@example.com	広島県
戎 はるみ	ebisu_harumi@example.com	静岡県
田中 明慶	tanaka_akiyoshi@example.com	茨城県
吉岡 莉緒	yoshioka_rio@example.com	愛知県
竹村 さやか	takemura_sayaka@example.com	福島県
藤崎 聡	fujisaki_satoshi@example.com	愛知県
石橋 仁晶	ishibashi_hiroaki@example.com	神奈川県
戎 亮介	ebisu_ryousuke@example.com	神奈川県
岩田 淳子	iwata_atsuko@example.com	茨城県
熊谷 一樹	kumagaya_kazuki@example.com	山梨県
滝 杏	taki_ann@example.com	鹿児島県
戎 徹平	ebisu_teppei@example.com	佐賀県
浜田 麻緒	hamada_mao@example.com	京都府
金児 璃奈子	kaneko_rinako1@example.com	岐阜県
和泉 真一	waizumi_shinichi@example.com	東京都
神戸 茂樹	koube_shigeki@example.com	岡山県
若槻 桃子	wakatsuki_momoko@example.com	愛媛県
黒谷 大樹	kurotani_hiroki@example.com	香川県
大沼 真希	oonuma_maki@example.com	東京都
草野 克実	kusano_katsumi@example.com	岡山県
児島 明	kojima_akira@example.com	宮城県
喜多 正敏	kita_masatoshi@example.com	大阪府
小市 涼子	koichi_ryouko@example.com	埼玉県
坂井 朝陽	sakai_asahi@example.com	東京都
青野 洋介	aono_yousuke@example.com	埼玉県
土井 涼子	doi_ryouko@example.com	東京都
高柳 たかお	takayanagi_takao@example.com	島根県
塚本 未來	tsukamoto_mirai@example.com	三重県
遠藤 公顕	enndou_kimiaki@example.com	栃木県
大畑 華子	oohata_hanako@example.com	茨城県
杉原 豊	sugihara_yutaka@example.com	神奈川県
城咲 美和子	shirosaki_miwako@example.com	兵庫県
滝口 雅彦	takiguchi_masahiko@example.com	栃木県
谷 真帆	tani_maho@example.com	東京都
滝本 茂樹	takimoto_shigeki@example.com	大阪府
阪本 敦	sakamoto_atsushi@example.com	兵庫県
曽根 友以乃	sone_yuino@example.com	埼玉県
新谷 なつみ	araya_natsumi@example.com	北海道
首藤 咲	sudou_saki@example.com	神奈川県
細川 勇介	hosokawa_yuusuke@example.com	埼玉県
土田 綾女	tsuchida_ayame@example.com	三重県
清田 崇史	kiyota_takashi@example.com	山形県
藤森 美嘉	fujimori_mika@example.com	愛知県
喜多 真悠子	kita_mayuko@example.com	佐賀県
蛍原 あおい	hotohara_aoi@example.com	東京都
岩田 結衣	iwata_yui@example.com	大阪府
有馬 砂羽	arima_sawa@example.com	北海道
大矢 豊	ooya_yutaka@example.com	東京都
石田 和之	ishida_kazuyuki@example.com	大分県
石川 晋也	ishikawa_shinya@example.com	千葉県
須賀 光良	suga_teruyoshi@example.com	福岡県
日下部 満	kusakabe_mitsuru@example.com	愛媛県
畑中 未來	hatanaka_mirai@example.com	千葉県
東 花緑	higashi_karoku@example.com	京都府
野中 明	nonaka_akira@example.com	神奈川県
上条 詩織	kamijou_shiori@example.com	長野県
竹中 秀隆	takenaka_hidetaka@example.com	山口県
藤山 浩太郎	fujiyama_koutarou@example.com	福岡県
戸塚 未來	toduka_mirai@example.com	大阪府
沢田 晴臣	sawada_haruomi@example.com	大阪府
大川 染五郎	ookawa_somegorou@example.com	熊本県
丹野 太朗	tannno_tarou@example.com	熊本県
堀北 宏	horikita_hiroshi@example.com	千葉県
堀越 仁晶	horikoshi_hiroaki@example.com	沖縄県
玉井 竜也	tamai_tatsuya@example.com	熊本県
篠崎 寛	shinozaki_hiroshi@example.com	東京都
妹尾 栄一	seo_eiichi@example.com	群馬県
有田 育子	arita_ikuko@example.com	茨城県
日高 憲史	hidaka_norihito@example.com	三重県
大路 愛梨	ooji_airi@example.com	福岡県
根岸 有海	negishi_ami@example.com	千葉県
百瀬 裕司	momose_yuuji@example.com	石川県
寺島 みき	terajima_miki@example.com	茨城県
神谷 えみ	kamiya_emi@example.com	岐阜県
三好 光良	miyoshi_teruyoshi@example.com	大阪府
片岡 直人	kataoka_naoto@example.com	東京都
岩谷 雅彦	iwatani_masahiko@example.com	岐阜県
大和田 一樹	oowada_kazuki@example.com	兵庫県
本上 寛	honjo_hiroshi@example.com	岐阜県
竹下 丈雄	takeshita_takeo@example.com	沖縄県
長浜 恵子	nagahama_keiko@example.com	長野県
河野 和之	kouno_kazuyuki@example.com	福島県
松山 紗季	matsuyama_saki@example.com	埼玉県
金沢 めぐみ	kanezawa_megumi@example.com	千葉県
浅川 良介	asakawa_ryousuke@example.com	宮崎県
萩原 右京	hagiwara_ukyou@example.com	長野県
藤島 鉄二	fujishima_tetsuji@example.com	神奈川県
石沢 孝太郎	ishizawa_koutarou@example.com	三重県
上条 鉄洋	kamijou_tetsuhiro@example.com	鹿児島県
島津 満	shimadu_mitsuru@example.com	福岡県
石川 涼	ishikawa_ryou@example.com	愛知県
青山 由宇	aoyama_yuu@example.com	愛知県
角田 妃里	kadota_yuri@example.com	愛知県
河合 沙知絵	kawai_sachie@example.com	兵庫県
角田 遥	kadota_haruka@example.com	愛媛県
山上 璃奈子	yamagami_rinako@example.com	埼玉県
伊沢 礼子	izawa_reiko@example.com	福井県
相馬 未來	aiba_mirai@example.com	岐阜県
酒井 祐基	sakai_yuuki@example.com	千葉県
飯島 明慶	iijima_akiyoshi@example.com	愛知県
上山 満	kamiyama_mitsuru@example.com	宮城県
北島 信吾	kitajima_shingo@example.com	福岡県
倉持 那奈	kuramochi_nana@example.com	静岡県
高沢 獅童	takasawa_shidou@example.com	長野県
片桐 まなみ	katagiri_manami@example.com	愛媛県
星野 きみまろ	hoshino_kimimaro@example.com	鹿児島県
林田 彩華	hayashida_ayaka@example.com	埼玉県
坂東 樹里	banntou_juri@example.com	福岡県
三橋 美嘉	mihashi_mika@example.com	兵庫県
有村 光臣	arimura_mitsuomi@example.com	北海道
吉野 なつみ	yoshino_natsumi@example.com	福岡県
筒井 希	tsutsui_nozomi@example.com	大阪府
依田 美幸	yorita_miyuki@example.com	愛知県
首藤 勇介	sudou_yuusuke@example.com	新潟県
米倉 さゆり	yonekura_sayuri@example.com	大阪府
難波 美嘉	nannba_mika@example.com	山形県
山岸 なつみ	yamagishi_natsumi@example.com	千葉県
吉田 佳乃	yoshida_yoshino@example.com	東京都
大橋 たまき	oohashi_tamaki@example.com	神奈川県
木村 慢太郎	kimura_mantarou@example.com	岐阜県
赤松 サンタマリア	akamatsu_stmaria@example.com	広島県
川西 あき	kawanishi_aki@example.com	愛知県
竹下 咲	takeshita_saki@example.com	福岡県
水上 さんま	mizukami_sanma@example.com	千葉県
磯野 美月	isono_miduki@example.com	福島県
半田 一輝	hannda_kazuki@example.com	東京都
杉下 草太	sugishita_souta@example.com	群馬県
村上 優	murakami_yuu@example.com	福岡県
植松 裕次郎	uematsu_yuujirou@example.com	宮崎県
小椋 貴嶺	ogura_takane@example.com	群馬県
布川 長利	fukawa_nagatoshi@example.com	兵庫県
末永 莉沙	suenaga_risa@example.com	埼玉県
秋山 寛治	akiyama_kanji@example.com	福島県
宮城 未來	miyagi_mirai@example.com	広島県
岡本 友也	okamoto_tomoya@example.com	長野県
喜多 礼子	kita_reiko@example.com	兵庫県
北川 竜也	kitagawa_tatsuya@example.com	岡山県
大山 莉央	ooyama_rio@example.com	兵庫県
浅見 隆	asami_takashi@example.com	沖縄県
五味 奈央	gomi_nao@example.com	愛媛県
木下 英嗣	kinoshita_hidetsugu@example.com	神奈川県
相馬 徹	aiba_tooru@example.com	北海道
梅本 彩	umemoto_aya@example.com	埼玉県
仲村 和香	nakamura_waka@example.com	茨城県
上村 貴美子	uemura_kimiko@example.com	新潟県
安田 華子	yasuda_hanako@example.com	宮崎県
松川 茂樹	matsukawa_shigeki@example.com	新潟県
細井 マサカズ	hosoi_masakazu@example.com	京都府
石田 雅彦	ishida_masahiko@example.com	群馬県
田辺 さゆり	tanabe_sayuri@example.com	大阪府
伴 功補	ban_kousuke@example.com	群馬県
園田 勇	sonoda_yuu@example.com	熊本県
唐沢 礼子	karasawa_reiko@example.com	徳島県
城咲 りえ	shirosaki_rie@example.com	奈良県
広川 洋介	hirokawa_yousuke@example.com	埼玉県
片桐 大	katagiri_masaru@example.com	東京都
松元 賢二	matsumoto_kenji@example.com	岩手県
上田 利夫	ueda_toshio@example.com	神奈川県
羽田 宏	hata_hiroshi@example.com	広島県
高梨 竜也	takanashi_tatsuya@example.com	静岡県
紺野 博明	konnno_hiroaki@example.com	鹿児島県
沢村 友以乃	sawamura_yuino@example.com	秋田県
志村 由美子	shimura_yumiko@example.com	千葉県
石野 雅彦	ishino_masahiko@example.com	愛知県
福士 樹里	fukushi_juri@example.com	北海道
平尾 さゆり	hirao_sayuri@example.com	広島県
西井 雅彦	nishii_masahiko@example.com	福岡県
江口 しぼり	eguchi_shibori@example.com	神奈川県
板垣 遥	itagaki_haruka@example.com	長野県
対馬 愛	tsushima_ai@example.com	埼玉県
石橋 真吾	ishibashi_shingo@example.com	大阪府
とよた 信吾	toyota_shingo@example.com	兵庫県
福士 朝陽	fukushi_asahi@example.com	香川県
高梨 綾女	takanashi_ayame@example.com	大阪府
塩谷 兼	shiotani_ken@example.com	千葉県
中川 守	nakagawa_mamoru@example.com	大阪府
芳賀 美咲	haga_misaki@example.com	佐賀県
米山 美幸	yoneyama_miyuki@example.com	鹿児島県
神崎 亜希	kannzaki_aki@example.com	神奈川県
桑原 希	kuwabara_nozomi@example.com	鹿児島県
大路 真一	ooji_shinichi@example.com	岐阜県
堀江 美佳	horie_mika@example.com	東京都
中原 エリカ	nakahara_erika@example.com	埼玉県
江口 小雁	eguchi_kogan@example.com	神奈川県
長瀬 寿々花	nagase_suzuka@example.com	愛知県
市田 亮	ichida_ryou@example.com	福岡県
秋本 郁恵	akimoto_ikue@example.com	神奈川県
菅野 広之	sugano_hiroyuki@example.com	宮城県
小宮 鉄二	komiya_tetsuji@example.com	愛知県
高柳 まさみ	takayanagi_masami@example.com	埼玉県
五味 由宇	gomi_yuu@example.com	京都府
谷口 秀隆	taniguchi_hidetaka@example.com	愛知県
一木 桃子	ichiki_momoko@example.com	神奈川県
阿井 美菜	ai_mina@example.com	千葉県
高橋 綾	takahashi_aya@example.com	埼玉県
目黒 明日	meguro_meibi@example.com	宮崎県
ほしの 勝久	hoshino_katsuhisa@example.com	群馬県
川口 慎之介	kawaguchi_shinnosuke@example.com	埼玉県
平 信輔	taira_shinsuke@example.com	和歌山県
有馬 礼子	arima_reiko@example.com	福岡県
大山 まさし	ooyama_masashi@example.com	新潟県
坂口 サンタマリア	sakaguchi_stmaria@example.com	大阪府
宮下 はじめ	miyashita_hajime@example.com	和歌山県
有馬 千夏	arima_chinatsu@example.com	鳥取県
今泉 孝太郎	imaizumi_koutarou@example.com	岐阜県
丹野 えみ	tannno_emi@example.com	香川県
津田 花	tsuda_hana@example.com	岩手県
田崎 獅童	tazaki_shidou@example.com	愛知県
芳賀 精児	haga_seiji@example.com	広島県
谷川 悟志	tanikawa_satoshi@example.com	岡山県
望月 れいな	mochiduki_reina@example.com	愛知県
伊崎 杏	isaki_ann@example.com	東京都
宮城 哲平	miyagi_teppei@example.com	東京都
菅野 サンタマリア	kanno_stmaria@example.com	熊本県
菊池 仁	kikuchi_jin@example.com	神奈川県
宮島 涼	miyajima_ryou@example.com	北海道
山上 貴嶺	yamagami_takane@example.com	石川県
土谷 長利	tsuchiya_nagatoshi@example.com	茨城県
二宮 妃里	ninomiya_yuri@example.com	東京都
野口 芽以	noguchi_mei@example.com	山口県
三浦 碧海	miura_ouga@example.com	長野県
二宮 りえ	ninomiya_rie@example.com	東京都
境 寿々花	sakai_suzuka@example.com	神奈川県
岩下 徹	iwashita_tooru@example.com	佐賀県
滝川 雅彦	takigawa_masahiko@example.com	神奈川県
中 奈々	naka_nana@example.com	福島県
おかやま 美月	okayama_miduki@example.com	東京都
岩村 恵美	iwamura_megumi@example.com	北海道
加瀬 奈月	kase_natsuki@example.com	東京都
中園 里穂	nakazono_riho@example.com	神奈川県
桑田 友以乃	kuwata_yuino@example.com	千葉県
小椋 彩	ogura_aya@example.com	三重県
根本 敦	nemoto_atsushi@example.com	岐阜県
今川 亮	imagawa_ryou@example.com	岐阜県
生田 美咲	namata_misaki@example.com	石川県
相原 朝陽	aihara_asahi@example.com	福井県
小野 涼	ono_ryou@example.com	兵庫県
牧田 真帆	makita_maho@example.com	岡山県
落合 薫	ochiai_kaoru@example.com	神奈川県
川越 美智子	kawagoe_michiko@example.com	静岡県
田沢 美佐子	tazawa_misako@example.com	徳島県
古谷 雅功	furutani_masatoshi@example.com	長野県
山崎 信輔	yamazaki_shinsuke@example.com	鹿児島県
栗原 直人	kurihara_naoto@example.com	神奈川県
富岡 光博	tomioka_mitsuhiro@example.com	岡山県
早美 亮	hayami_ryou@example.com	福岡県
目黒 桃子	meguro_momoko@example.com	島根県
寺岡 奈月	teraoka_natsuki@example.com	岡山県
今川 由宇	imagawa_yuu@example.com	福岡県
野原 隆太	nohara_ryuuta@example.com	栃木県
角田 美智子	kadota_michiko@example.com	神奈川県
岸 耕司	kishi_kouji@example.com	広島県
高柳 将也	takayanagi_masaya@example.com	茨城県
瀬戸内 佳乃	setouchi_yoshino@example.com	北海道
渡辺 貴嶺	watanabe_takane@example.com	香川県
金井 郁恵	kanai_ikue@example.com	北海道
大河内 奈々	ookouchi_nana@example.com	大阪府
野本 フミヤ	nomoto_fumiya@example.com	千葉県
内野 右京	uchino_ukyou@example.com	千葉県
半田 恵梨香	hannda_erika@example.com	愛知県
中 早紀	naka_saki@example.com	大阪府
森口 美佳	moriguchi_mika@example.com	和歌山県
小川 ヒロ	ogawa_hiro@example.com	新潟県
金田 光洋	kaneda_mitsuhiro@example.com	東京都
今西 育二	imanishi_ikuji@example.com	高知県
宮内 美嘉	miyauchi_mika@example.com	大阪府
及川 龍吉	oikawa_ryuukichi@example.com	山口県
矢口 あき	yaguchi_aki@example.com	東京都
阿部 真悠子	abe_mayuko@example.com	山梨県
鳥居 桃子	torii_momoko@example.com	大阪府
八十田 兼	yasoda_ken@example.com	大阪府
若槻 真帆	wakatsuki_maho@example.com	岐阜県
荒川 憲史	arakawa_norihito@example.com	徳島県
石崎 美咲	ishizaki_misaki@example.com	福岡県
有賀 怜奈	ariga_reina@example.com	群馬県
川井 直人	kawai_naoto@example.com	三重県
末永 勇介	suenaga_yuusuke@example.com	徳島県
成瀬 仁	naruse_jin@example.com	北海道
渡辺 サダヲ	watanabe_sadawo@example.com	東京都
本橋 明	motohashi_akira@example.com	京都府
難波 美佳	nannba_mika1@example.com	熊本県
神崎 マサカズ	kanzaki_masakazu@example.com	東京都
岩井 広之	iwai_hiroyuki@example.com	長崎県
大路 莉央	ooji_rio@example.com	沖縄県
大木 雄太	ooki_yuuta@example.com	岐阜県
長島 瑠璃亜	nagashima_ruria@example.com	大阪府
増井 仁晶	masui_hiroaki@example.com	神奈川県
臼井 隼士	usui_shunji@example.com	北海道
菅原 サダヲ	sugawara_sadawo@example.com	東京都
首藤 美幸	sudou_miyuki@example.com	埼玉県
寺本 啓介	teramoto_keisuke@example.com	兵庫県
今 隆博	kon_takahiro@example.com	愛媛県
北沢 結衣	kitazawa_yui@example.com	大阪府
西村 鉄洋	nishimura_tetsuhiro@example.com	岐阜県
武藤 ひかり	mutou_hikari@example.com	大阪府
磯村 亜希	isomura_aki@example.com	新潟県
富永 光良	tominaga_teruyoshi@example.com	神奈川県
小宮 精児	komiya_seiji@example.com	広島県
藤山 貴美子	fujiyama_kimiko@example.com	千葉県
井田 光	ida_hikaru@example.com	群馬県
富田 康文	tomita_yasufumi@example.com	富山県
吹越 りえ	fukikoshi_rie@example.com	福岡県
平松 博之	hiramatsu_hiroyuki@example.com	埼玉県
沼田 徹平	numata_teppei@example.com	大阪府
林 友也	hayashi_tomoya@example.com	神奈川県
小椋 亮	ogura_ryou@example.com	福岡県
上野 郁恵	ueno_ikue@example.com	千葉県
藤沢 直人	fujisawa_naoto@example.com	福島県
ユースケ 照生	yusuke_teruo@example.com	長崎県
永田 佳乃	nagata_yoshino@example.com	神奈川県
玉木 圭	tamaki_kei@example.com	兵庫県
寺田 勇	terada_yuu@example.com	兵庫県
今 恵子	kon_keiko@example.com	京都府
岩本 綾女	iwamoto_ayame@example.com	北海道
落合 亮介	ochiai_ryousuke@example.com	京都府
高尾 幸子	takao_sachiko@example.com	群馬県
亀山 功補	kameyama_kousuke@example.com	福岡県
熊谷 直人	kumagaya_naoto@example.com	沖縄県
吉沢 奈月	yoshizawa_natsuki@example.com	東京都
千葉 精児	chiba_seiji@example.com	大阪府
吉川 ケンイチ	yoshikawa_kenichi@example.com	埼玉県
溝口 詩織	mizoguchi_shiori@example.com	福島県
岡野 将也	okano_masaya@example.com	愛知県
児島 幸平	kojima_kouhei@example.com	兵庫県
藤山 雅彦	fujiyama_masahiko@example.com	東京都
大坂 宏	oosaka_hiroshi@example.com	宮城県
河原 碧海	kawahara_ouga@example.com	長野県
相原 知世	aihara_chise@example.com	京都府
三谷 郁恵	mitani_ikue@example.com	北海道
狩野 六郎	kano_rokurou@example.com	沖縄県
高畑 夏希	takabata_natsuki@example.com	兵庫県
本多 信輔	honnda_shinsuke@example.com	山口県
白井 杏	shirai_ann@example.com	三重県
篠崎 聡	shinozaki_satoshi@example.com	大阪府
三橋 亮	mihashi_ryou@example.com	東京都
上田 ジローラモ	ueda_girolamo@example.com	鳥取県
喜多 理紗	kita_risa@example.com	大阪府
三船 サダヲ	mifune_sadawo1@example.com	東京都
渋谷 瞬	shibuya_shun@example.com	埼玉県
長谷川 綾女	hasegawa_ayame@example.com	大分県
相田 さとみ	aida_satomi@example.com	高知県
角田 薫	kadota_kaoru@example.com	岐阜県
末永 陽子	suenaga_youko@example.com	埼玉県
宮脇 美佐子	miyawaki_misako@example.com	青森県
竹下 真帆	takeshita_maho@example.com	愛知県
三枝 まさし	sannshi_masashi@example.com	茨城県
玉木 なつみ	tamaki_natsumi@example.com	東京都
神野 智花	kamino_tomoka@example.com	神奈川県
香椎 ヒロ	kashii_hiro@example.com	大阪府
加藤 寿々花	katou_suzuka@example.com	秋田県
大森 健	oomori_ken@example.com	北海道
市田 小百合	ichida_sayuri@example.com	愛知県
永井 恵梨香	nagai_erika@example.com	東京都
浜本 さやか	hamamoto_sayaka@example.com	栃木県
瀬戸内 獅童	setouchi_shidou@example.com	千葉県
井川 孝太郎	igawa_koutarou@example.com	東京都
田村 雅彦	tamura_masahiko@example.com	長野県
彼方 徹	kanata_tohru@example.com	兵庫県
奥田 敏和	okuda_toshikazu@example.com	神奈川県
杉浦 愛	sugiura_ai@example.com	熊本県
芦田 敦	ashida_atsushi@example.com	千葉県
落合 寛治	ochiai_kanji@example.com	岩手県
柴田 耕司	shibata_kouji@example.com	東京都
浜野 麻由子	hamano_mayuko@example.com	東京都
田川 博之	tagawa_hiroyuki@example.com	東京都
川上 小百合	kawakami_sayuri@example.com	愛知県
大森 知史	oomori_tomofumi@example.com	岡山県
山内 里奈	yamanouchi_rina@example.com	愛知県
城戸 寛	kido_hiroshi@example.com	福岡県
須田 和久	suda_kazuhisa@example.com	京都府
杉野 研二	sugino_kenji@example.com	東京都
香椎 功補	kashii_kousuke@example.com	愛媛県
金丸 守	kanamaru_mamoru@example.com	大阪府
小西 研二	konishi_kenji@example.com	高知県
亀井 ちえみ	kamei_chiemi@example.com	千葉県
玉置 哲平	tamaki_teppei@example.com	神奈川県
福沢 陽介	fukuzawa_yousuke@example.com	千葉県
上田 希	ueda_nozomi@example.com	山梨県
椎名 淳	shiina_atsushi@example.com	神奈川県
雨宮 菜々美	amamiya_nanami@example.com	神奈川県
徳田 菜々美	tokuta_nanami@example.com	神奈川県
小平 浩介	kohira_kousuke@example.com	兵庫県
山上 ひとみ	yamagami_hitomi@example.com	兵庫県
野原 さやか	nohara_sayaka@example.com	神奈川県
花岡 和久	hanaoka_kazuhisa@example.com	和歌山県
寺脇 育二	terawaki_ikuji@example.com	愛知県
板倉 サダヲ	itakura_sadawo@example.com	千葉県
高松 信輔	takamatsu_shinsuke@example.com	熊本県
平 真希	taira_maki@example.com	沖縄県
清水 悟志	shimizu_satoshi@example.com	埼玉県
遠山 晴臣	tooyama_haruomi@example.com	福岡県
近藤 大樹	kondou_hiroki@example.com	新潟県
清水 芽以	shimizu_mei@example.com	神奈川県
角谷 きみまろ	kadotani_kimimaro@example.com	埼玉県
大村 敏和	oomura_toshikazu@example.com	愛知県
清野 杏	kiyono_ann@example.com	北海道
中原 龍吉	nakahara_ryuukichi@example.com	徳島県
片瀬 瞬	katase_shun@example.com	兵庫県
菊地 由樹	kikuchi_yuki@example.com	神奈川県
相武 雅彦	aibu_masahiko@example.com	東京都
角谷 路子	kadotani_michiko@example.com	愛知県
山根 さんま	yamane_sanma@example.com	東京都
角田 美希	kadota_miki@example.com	新潟県
三原 怜奈	mihara_reina1@example.com	東京都
細川 未來	hosokawa_mirai@example.com	京都府
宮田 サダヲ	miyata_sadawo@example.com	秋田県
大和 ヒロ	yamato_hiro@example.com	青森県
井川 咲	igawa_saki@example.com	山梨県
落合 寛	ochiai_hiroshi@example.com	熊本県
石田 友也	ishida_tomoya@example.com	埼玉県
相田 ひろみ	aida_hiromi@example.com	神奈川県
長沢 敦	nagasawa_atsushi@example.com	神奈川県
峰 あや子	mine_ayako@example.com	大阪府
野村 竜也	nomura_tatsuya@example.com	滋賀県
青柳 光	aoyagi_hikaru@example.com	大阪府
沢田 小百合	sawada_sayuri@example.com	大阪府
宮城 千夏	miyagi_chinatsu@example.com	東京都
桜井 慶太	sakurai_keita@example.com	埼玉県
富山 英嗣	tomiyama_hidetsugu@example.com	福岡県
阿部 勤	abe_tsutomu@example.com	新潟県
桑原 明	kuwabara_akira@example.com	千葉県
吹石 みゆき	fukiishi_miyuki@example.com	宮城県
石黒 美月	ishiguro_miduki@example.com	兵庫県
武 草太	take_souta@example.com	大阪府
内藤 和香	naitou_waka@example.com	愛知県
池内 真一	ikeuchi_shinichi@example.com	熊本県
益田 涼子	masuda_ryouko@example.com	宮城県
田川 明日	tagawa_meibi@example.com	神奈川県
日高 まひる	hidaka_mahiru@example.com	静岡県
堀口 洋介	horiguchi_yousuke@example.com	群馬県
唐沢 恵梨香	karasawa_erika@example.com	福岡県
山中 あおい	yamanaka_aoi@example.com	沖縄県
松山 満	matsuyama_mitsuru@example.com	愛知県
岩淵 慶二	iwabuchi_keiji@example.com	大阪府
北原 右京	kitahara_ukyou@example.com	愛知県
横川 恵梨香	yokokawa_erika@example.com	大阪府
葛西 晋也	kasai_shinya@example.com	東京都
大泉 俊二	ooizumi_shunji@example.com	京都府
渡部 恵美	watabe_megumi@example.com	長野県
寺田 郁恵	terada_ikue@example.com	埼玉県
田淵 信吾	tabuchi_shingo@example.com	東京都
浦野 愛子	urano_aiko@example.com	兵庫県
沢田 瑠璃亜	sawada_ruria@example.com	岐阜県
乾 獅童	inui_shidou@example.com	埼玉県
金田 由宇	kaneda_yuu@example.com	神奈川県
福田 優	fukuda_yuu@example.com	福岡県
三枝 明	sannshi_akira@example.com	愛知県
相原 草太	aihara_souta@example.com	三重県
栗山 未來	kuriyama_mirai@example.com	千葉県
小野田 早織	onoda_saori@example.com	埼玉県
久保田 麗奈	kubota_rena@example.com	新潟県
佐川 晃司	sagawa_kouji@example.com	熊本県
平井 宏行	hirai_hiroyuki@example.com	兵庫県
土田 美優	tsuchida_myuu@example.com	東京都
松村 まひる	matsumura_mahiru@example.com	千葉県
那須 祐基	nasu_yuuki@example.com	東京都
河本 景子	koumoto_keiko@example.com	大分県
進藤 光臣	shinndou_mitsuomi@example.com	北海道
角谷 遥	kadotani_haruka@example.com	新潟県
服部 明	hattori_akira@example.com	京都府
相武 小百合	aibu_sayuri@example.com	福岡県
田辺 鉄二	tanabe_tetsuji@example.com	長崎県
渡辺 マサカズ	watanabe_masakazu@example.com	神奈川県
天野 敦	amano_atsushi@example.com	石川県
石川 はるか	ishikawa_haruka@example.com	神奈川県
奥貫 由宇	okunuki_yuu@example.com	静岡県
中島 まさみ	nakajima_masami@example.com	愛知県
園田 佳乃	sonoda_yoshino@example.com	大阪府
氏家 みゆき	ujiie_miyuki@example.com	北海道
塩沢 晴臣	shiozawa_haruomi@example.com	青森県
金児 鉄二	kaneko_tetsuji@example.com	埼玉県
深沢 隼士	fukazawa_shunji@example.com	北海道
三輪 良介	miwa_ryousuke@example.com	滋賀県
田中 慶太	tanaka_keita@example.com	広島県
吉永 さとみ	yoshinaga_satomi@example.com	神奈川県
渡辺 杏	watanabe_ann@example.com	埼玉県
麻生 龍吉	asou_ryuukichi@example.com	青森県
小沼 美菜	konuma_mina@example.com	神奈川県
白鳥 真一	shiratori_shinichi@example.com	大阪府
西村 しほり	nishimura_shihori@example.com	埼玉県
塩沢 信吾	shiozawa_shingo@example.com	大阪府
芦屋 照生	ashiya_teruo@example.com	新潟県
谷 まなみ	tani_manami@example.com	埼玉県
大和田 友也	oowada_tomoya@example.com	岐阜県
片岡 茜	kataoka_akane@example.com	兵庫県
大倉 朝陽	ookura_asahi@example.com	沖縄県
湊 草太	minato_souta@example.com	千葉県
白鳥 優	shiratori_yuu@example.com	埼玉県
成田 由宇	narita_yuu@example.com	埼玉県
布川 華子	fukawa_hanako@example.com	埼玉県
高島 ヒロ	takashima_hiro@example.com	兵庫県
美輪 信吾	miwa_shingo@example.com	京都府
明石家 聖陽	akashiya_masaaki@example.com	鹿児島県
石垣 恵梨香	ishigaki_erika@example.com	東京都
今西 直人	imanishi_naoto@example.com	東京都
宮城 聡	miyagi_satoshi@example.com	大阪府
植田 拓郎	ueta_takurou@example.com	神奈川県
富永 めぐみ	tominaga_megumi@example.com	神奈川県
大崎 育二	oosaki_ikuji@example.com	兵庫県
三島 寛	mishima_hiroshi@example.com	宮城県
高山 聡	takayama_satoshi@example.com	広島県
岡本 浩介	okamoto_kousuke@example.com	静岡県
田上 璃奈子	taue_rinako@example.com	広島県
早坂 米蔵	hayasaka_yonezou@example.com	香川県
古田 しぼり	furuta_shibori@example.com	東京都
木本 良介	kimoto_ryousuke@example.com	大阪府
石黒 研二	ishiguro_kenji@example.com	愛媛県
花田 えみ	hanada_emi@example.com	栃木県
阿部 徹	abe_tooru@example.com	愛知県
杉浦 慶太	sugiura_keita@example.com	島根県
大泉 英嗣	ooizumi_hidetsugu@example.com	埼玉県
荒川 友也	arakawa_tomoya@example.com	大阪府
車 充則	kuruma_mitsunori@example.com	広島県
深田 隼士	fukada_shunji@example.com	沖縄県
津川 禄郎	tsugawa_rokurou@example.com	愛媛県
小玉 弘也	kodama_hironari@example.com	静岡県
加納 三省	kanou_sansei@example.com	和歌山県
川原 理紗	kawahara_risa@example.com	埼玉県
塚原 璃奈子	tsukahara_rinako@example.com	群馬県
畠山 昌代	hatayama_masayo@example.com	青森県
岡村 徹	okamura_tooru@example.com	沖縄県
中根 拓郎	nakane_takurou@example.com	北海道
北原 慢太郎	kitahara_mantarou@example.com	東京都
吹越 美智子	fukikoshi_michiko@example.com	茨城県
堀江 瑠璃亜	horie_ruria@example.com	滋賀県
牧 麻由子	maki_mayuko@example.com	滋賀県
高見 明	takami_akira@example.com	神奈川県
小寺 綾	kodera_aya@example.com	広島県
古川 俊介	furukawa_shunsuke@example.com	福井県
大庭 和久	ooniwa_kazuhisa@example.com	京都府
神木 幸平	kamiki_kouhei@example.com	東京都
山西 麻緒	yamanishi_mao@example.com	千葉県
立石 倫子	tachiishi_noriko@example.com	神奈川県
村上 あさみ	murakami_asami@example.com	埼玉県
小菅 ちえみ	kosuge_chiemi@example.com	福岡県
松山 菜摘	matsuyama_natsumi@example.com	岐阜県
市村 恭子	ichimura_kyouko@example.com	東京都
上田 優	ueda_yuu@example.com	大阪府
大浦 彩	ooura_aya@example.com	東京都
田畑 崇史	tabata_takashi@example.com	神奈川県
片桐 法嗣	katagiri_houshi@example.com	北海道
安部 メイサ	abe_meisa@example.com	東京都
金谷 ケンイチ	kanaya_kenichi@example.com	福岡県
横田 右京	yokota_ukyou@example.com	埼玉県
日比野 さゆり	hibino_sayuri@example.com	福岡県
芹沢 豊	serizawa_yutaka@example.com	埼玉県
三好 孝太郎	miyoshi_koutarou@example.com	福岡県
山川 晴臣	yamakawa_haruomi@example.com	神奈川県
安座間 由美子	azama_yumiko@example.com	千葉県
鹿手袋 直人	shikatebukuro_naoto@example.com	兵庫県
対馬 真悠子	tsushima_mayuko@example.com	栃木県
松尾 景子	matsuo_keiko@example.com	福島県
田端 美優	tabata_myuu@example.com	愛知県
浅野 あおい	asano_aoi@example.com	千葉県
久保田 貴美子	kubota_kimiko@example.com	千葉県
横山 麻由子	yokoyama_mayuko@example.com	岐阜県
本山 広司	honnyama_kouji@example.com	鹿児島県
星野 俊二	hoshino_shunji@example.com	静岡県
小田 ノブヒコ	oda_nobuhiko@example.com	静岡県
竹田 ヒロ	takeda_hiro@example.com	神奈川県
黒木 南朋	kuroki_nao@example.com	埼玉県
秦 浩太郎	hata_koutarou@example.com	茨城県
松山 恵望子	matsuyama_emiko@example.com	福岡県
森永 奈月	morinaga_natsuki@example.com	埼玉県
小池 正敏	koike_masatoshi@example.com	大阪府
伊崎 めぐみ	isaki_megumi@example.com	大分県
末永 勝久	suenaga_katsuhisa@example.com	佐賀県
落合 憲一	ochiai_kenichi@example.com	兵庫県
宮内 浩太郎	miyauchi_koutarou@example.com	北海道
志村 莉央	shimura_rio@example.com	埼玉県
岩井 俊介	iwai_shunsuke@example.com	北海道
中島 禄郎	nakashima_rokurou@example.com	千葉県
池上 弘也	ikegami_hironari@example.com	東京都
小堀 秀隆	kohori_hidetaka@example.com	東京都
戸田 直人	toda_naoto@example.com	静岡県
根岸 浩介	negishi_kousuke@example.com	宮崎県
東 真帆	higashi_maho@example.com	福岡県
古田 りえ	furuta_rie@example.com	長崎県
相原 まなみ	aihara_manami@example.com	長野県
寺脇 愛子	terawaki_aiko@example.com	福岡県
丸田 明宏	maruta_akihiro@example.com	東京都
磯村 ひろみ	isomura_hiromi@example.com	秋田県
西浦 礼子	nishiura_reiko@example.com	広島県
伊藤 一代	itou_kazuyo@example.com	愛知県
田崎 賢二	tazaki_kenji@example.com	埼玉県
内村 里穂	uchimura_riho@example.com	青森県
水野 なつみ	mizuno_natsumi@example.com	愛知県
金森 一輝	kanamori_kazuki@example.com	茨城県
小野 慢太郎	ono_mantarou@example.com	長野県
大庭 雅之	ooniwa_masayuki@example.com	東京都
谷口 竜也	taniguchi_tatsuya@example.com	神奈川県
大森 さとみ	oomori_satomi@example.com	大阪府
外山 ヒカル	sotoyama_hikaru@example.com	青森県
日下部 小雁	kusakabe_kogan@example.com	鹿児島県
水崎 徹	misaki_tooru@example.com	千葉県
有村 涼	arimura_ryou@example.com	静岡県
吉崎 朝陽	yoshizaki_asahi@example.com	大阪府
松川 弘也	matsukawa_hironari@example.com	北海道
藤村 隆博	fujimura_takahiro@example.com	山梨県
山田 勇	yamada_yuu@example.com	東京都
戸田 なつみ	toda_natsumi@example.com	沖縄県
寺井 未來	terai_mirai@example.com	静岡県
中里 精児	nakazato_seiji@example.com	栃木県
長井 くるみ	nagai_kurumi@example.com	東京都
井川 めぐみ	igawa_megumi@example.com	山形県
藤原 莉緒	fujiwara_rio@example.com	兵庫県
高見 はるか	takami_haruka@example.com	大阪府
寺島 かおり	terashima_kaori@example.com	兵庫県
白石 さやか	shiraishi_sayaka@example.com	岡山県
坂上 さやか	sakagami_sayaka@example.com	群馬県
明石 育子	akashi_ikuko@example.com	岡山県
三沢 隆太	misawa_ryuuta@example.com	千葉県
久保田 利夫	kubota_toshio@example.com	奈良県
五味 健	gomi_ken@example.com	山口県
小林 丈史	kobayashi_takeshi@example.com	山形県
中島 莉緒	nakajima_rio@example.com	秋田県
山野 恵梨香	yamano_erika@example.com	京都府
塚原 由宇	tsukahara_yuu@example.com	大分県
杉野 敏也	sugino_toshiya@example.com	大阪府
石沢 育二	ishizawa_ikuji@example.com	福岡県
玉井 美帆	tamai_miho@example.com	東京都
米谷 亮	yoneya_ryou@example.com	京都府
井口 奈央	iguchi_nao@example.com	京都府
北沢 雅彦	kitazawa_masahiko@example.com	秋田県
岩下 恭子	iwashita_kyouko@example.com	神奈川県
金城 仁	kanashiro_jin@example.com	大阪府
川越 詩織	kawagoe_shiori@example.com	沖縄県
吉原 敏和	yoshiwara_toshikazu@example.com	愛知県
茂木 小百合	mogi_sayuri@example.com	神奈川県
三谷 扶樹	mitani_motoki@example.com	佐賀県
おかやま 勝久	okayama_katsuhisa@example.com	広島県
新田 菜々美	arata_nanami@example.com	千葉県
伊沢 翔太	izawa_shouta@example.com	福井県
笠井 奈央	kasai_nao@example.com	神奈川県
古山 はじめ	furuyama_hajime@example.com	静岡県
長澤 知世	nagasawa_chise@example.com	新潟県
関根 はるか	sekine_haruka@example.com	福岡県
本山 涼	honnyama_ryou@example.com	山口県
平林 季衣	hirabayashi_toshie@example.com	秋田県
松本 沙耶	matsumoto_saya@example.com	富山県
合田 光博	aida_mitsuhiro@example.com	佐賀県
西岡 美菜	nishioka_mina@example.com	福岡県
滝口 雅彦	takiguchi_masahiko1@example.com	神奈川県
熊谷 雅彦	kumagaya_masahiko@example.com	神奈川県
今川 賢二	imagawa_kenji@example.com	山梨県
稲葉 あい	inaba_ai@example.com	長崎県
山上 奈央	yamagami_nao@example.com	埼玉県
吉本 瞳	yoshimoto_hitomi@example.com	埼玉県
井本 あい	imoto_ai@example.com	埼玉県
白井 サダヲ	shirai_sadawo@example.com	沖縄県
笠井 建	kasai_ken@example.com	東京都
落合 はじめ	ochiai_hajime@example.com	東京都
河原 綾女	kawahara_ayame@example.com	北海道
小野田 雅彦	onoda_masahiko@example.com	石川県
池谷 朝香	iketani_asaka@example.com	群馬県
塩見 憲一	shiomi_kenichi@example.com	石川県
新垣 さんま	niigaki_sanma@example.com	兵庫県
沢田 了	sawada_ryou@example.com	大阪府
米沢 彩	yonezawa_aya@example.com	奈良県
相原 花	aihara_hana@example.com	兵庫県
西沢 大五郎	nishizawa_daigorou@example.com	香川県
多部 花	tabe_hana@example.com	東京都
小田島 晃司	odajima_kouji@example.com	秋田県
青山 美幸	aoyama_miyuki@example.com	福岡県
渡部 満	watabe_mitsuru@example.com	愛知県
芦田 雅功	ashida_masatoshi@example.com	栃木県
唐沢 将也	karasawa_masaya@example.com	東京都
清水 由樹	shimizu_yuki@example.com	東京都
深田 杏	fukada_ann@example.com	鳥取県
松居 恵梨香	matsui_erika@example.com	東京都
金城 遥	kanashiro_haruka@example.com	愛知県
細山 瞬	hosoyama_shun@example.com	奈良県
安田 慎之介	yasuda_shinnosuke@example.com	大阪府
徳重 亜希	tokushige_aki@example.com	岩手県
今 真悠子	kon_mayuko@example.com	大阪府
根本 美優	nemoto_myuu@example.com	香川県
浅見 広司	asami_kouji@example.com	北海道
境 美月	sakai_miduki@example.com	群馬県
西島 悟志	nishijima_satoshi@example.com	鳥取県
小町 美幸	komachi_miyuki@example.com	京都府
今 佳乃	kon_yoshino@example.com	埼玉県
長友 真吾	nagatomo_shingo@example.com	埼玉県
麻生 貴嶺	asou_takane@example.com	東京都
益田 俊介	masuda_shunsuke@example.com	福井県
土谷 小雁	tsuchiya_kogan@example.com	栃木県
藤原 優	fujiwara_yuu@example.com	大阪府
古沢 知世	furusawa_chise@example.com	茨城県
内野 理紗	uchino_risa@example.com	長野県
池内 れいな	ikeuchi_reina@example.com	岩手県
角田 薫	kadota_kaoru1@example.com	福島県
対馬 豊	tsushima_yutaka@example.com	千葉県
鹿賀 直人	kaga_naoto@example.com	茨城県
有村 美希	arimura_miki@example.com	栃木県
岸部 美咲	kishibe_misaki@example.com	鳥取県
西野 あさみ	nishino_asami@example.com	茨城県
石坂 しほり	ishizaka_shihori@example.com	和歌山県
戸塚 亮介	toduka_ryousuke@example.com	宮城県
本間 将也	honma_masaya@example.com	群馬県
今 勇一	kon_yuuichi@example.com	茨城県
奥寺 由樹	okudera_yuki@example.com	福岡県
倉田 結衣	kurata_yui@example.com	岡山県
大竹 寛治	ootake_kanji@example.com	埼玉県
岩間 正敏	iwama_masatoshi@example.com	東京都
渡部 一代	watabe_kazuyo@example.com	東京都
浅見 未來	asami_mirai@example.com	滋賀県
野際 俊二	nogiwa_shunji@example.com	兵庫県
堀川 翔	horikawa_shou@example.com	長崎県
沢尻 みあ	sawajiri_mia@example.com	東京都
三好 さんま	miyoshi_sanma@example.com	東京都
香川 友以乃	kagawa_yuino@example.com	千葉県
佐野 由樹	sano_yuki@example.com	茨城県
野口 寛治	noguchi_kanji@example.com	神奈川県
寺脇 エリカ	terawaki_erika@example.com	愛媛県
菅野 三省	sugano_sansei@example.com	東京都
飛田 隆太	hida_ryuuta@example.com	大分県
中根 賢二	nakane_kenji@example.com	東京都
大内 怜奈	oouchi_reina@example.com	大阪府
山上 たまき	yamagami_tamaki@example.com	宮城県
植松 聡	uematsu_satoshi@example.com	東京都
柴田 徹平	shibata_teppei@example.com	大阪府
川原 隆博	kawahara_takahiro@example.com	宮城県
芦田 光	ashida_hikaru@example.com	東京都
竹下 光洋	takeshita_mitsuhiro@example.com	鹿児島県
玉田 右京	tamada_ukyou@example.com	岐阜県
狩野 三郎	kano_saburou@example.com	埼玉県
七瀬 法子	nanase_noriko@example.com	群馬県
本多 恵子	honnda_keiko@example.com	愛知県
滝本 菜々美	takimoto_nanami@example.com	埼玉県
茂木 徹	mogi_tooru@example.com	石川県
小西 真一	konishi_shinichi@example.com	長野県
中西 雅彦	nakanishi_masahiko@example.com	青森県
細谷 未華子	hosoya_mikako@example.com	兵庫県
浅利 真帆	asari_maho@example.com	大阪府
堀江 禄郎	horie_rokurou@example.com	秋田県
ともさか 隼士	tomosaka_shunji@example.com	北海道
高倉 サダヲ	takakura_sadawo@example.com	東京都
沢田 三郎	sawada_saburou@example.com	静岡県
根岸 浩正	negishi_hiromasa@example.com	京都府
安 美佐	yasu_misa@example.com	福岡県
安藤 満	ando_mitsuru@example.com	神奈川県
大塚 広之	ootsuka_hiroyuki@example.com	青森県
中岡 雅彦	nakaoka_masahiko@example.com	香川県
松野 莉緒	matsuno_rio@example.com	千葉県
役所 瞬	yakusho_shun@example.com	広島県
山岸 茜	yamagishi_akane@example.com	石川県
八十田 祐基	yasoda_yuuki@example.com	沖縄県
沢村 くるみ	sawamura_kurumi@example.com	岡山県
上田 功補	ueda_kousuke@example.com	福井県
広川 豊	hirokawa_yutaka@example.com	東京都
榎本 聖陽	enomoto_masaaki@example.com	愛知県
藤田 瞳	fujita_hitomi@example.com	沖縄県
児玉 エリカ	kodama_erika@example.com	静岡県
布施 ヒロ	fuse_hiro@example.com	静岡県
菅野 愛子	sugano_aiko@example.com	秋田県
島津 コウ	shimadu_kou@example.com	広島県
山崎 輝信	yamazaki_akinobu@example.com	千葉県
久米 光博	kume_mitsuhiro@example.com	岩手県
浅見 丈史	asami_takeshi@example.com	福岡県
尾崎 明日	ozaki_meibi@example.com	愛媛県
深田 充則	fukada_mitsunori@example.com	沖縄県
森 真希	mori_maki@example.com	愛知県
岩間 博明	iwama_hiroaki@example.com	石川県
平尾 愛菜	hirao_aina@example.com	島根県
布川 麻緒	fukawa_mao1@example.com	和歌山県
岩崎 希	iwasaki_nozomi@example.com	兵庫県
平野 幸平	hirano_kouhei@example.com	高知県
宇多田 鉄二	utada_tetsuji@example.com	兵庫県
大場 一輝	ooba_kazuki@example.com	大阪府
三輪 光博	miwa_mitsuhiro@example.com	神奈川県
杉下 翔太	sugishita_shouta@example.com	福岡県
中園 あい	nakazono_ai@example.com	新潟県
蒼井 ヒロ	aoi_hiro@example.com	大阪府
上条 有起哉	kamijou_yukiya@example.com	兵庫県
仲田 薫	nakata_kaoru@example.com	島根県
長岡 俊二	nagaoka_shunji@example.com	埼玉県
渡部 勤	watabe_tsutomu@example.com	大阪府
結城 美佳	yuuki_mika@example.com	兵庫県
高嶋 明慶	takashima_akiyoshi@example.com	大分県
鶴田 聡	tsuruta_satoshi@example.com	愛知県
大田 ノブヒコ	oota_nobuhiko@example.com	茨城県
神原 輝信	kannbara_akinobu@example.com	大分県
坂東 雅彦	banntou_masahiko@example.com	千葉県
熊井 メイサ	kumai_meisa@example.com	広島県
瀬尾 和久	seo_kazuhisa@example.com	群馬県
菅野 芳正	sugano_yoshimasa@example.com	東京都
小田 まなみ	oda_manami@example.com	北海道
熊井 みき	kumai_miki@example.com	東京都
三木 仁	miki_jin@example.com	愛媛県
柳沢 景子	yanagisawa_keiko@example.com	北海道
塚原 隼士	tsukahara_shunji@example.com	兵庫県
牧 惇	maki_atsushi@example.com	大分県
山村 裕司	yamamura_yuuji@example.com	奈良県
土谷 雅之	tsuchiya_masayuki@example.com	福島県
森 早織	mori_saori@example.com	福岡県
勝又 彩華	katsumata_ayaka@example.com	長野県
神保 フミヤ	jinbo_fumiya@example.com	奈良県
牧田 明宏	makita_akihiro@example.com	北海道
平井 淳	hirai_atsushi@example.com	北海道
深沢 みあ	fukazawa_mia@example.com	北海道
藤村 陽介	fujimura_yousuke@example.com	山形県
片桐 愛菜	katagiri_aina@example.com	福井県
春日 あおい	kasuga_aoi@example.com	兵庫県
若林 たまき	wakabayashi_tamaki@example.com	東京都
三船 美月	mifune_miduki@example.com	愛媛県
寺本 璃奈子	teramoto_rinako@example.com	徳島県
橋本 早織	hashimoto_saori@example.com	高知県
北島 仁	kitajima_jin@example.com	神奈川県
野口 翔	noguchi_shou@example.com	神奈川県
三浦 めぐみ	miura_megumi@example.com	岡山県
小林 拓郎	kobayashi_takurou@example.com	茨城県
中谷 ジローラモ	nakatani_girolamo@example.com	北海道
杉下 あや子	sugishita_ayako@example.com	兵庫県
深井 研二	fukai_kenji@example.com	千葉県
平林 由宇	hirabayashi_yuu@example.com	山梨県
福井 敦	fukui_atsushi@example.com	長野県
前島 惇	maejima_jun@example.com	京都府
本山 光良	honnyama_teruyoshi@example.com	愛媛県
岸本 祐一	kishimoto_yuuichi@example.com	神奈川県
筒井 惇	tsutsui_atsushi@example.com	岡山県
西原 亜希	nishihara_aki@example.com	大阪府
大沢 景子	oosawa_keiko@example.com	奈良県
谷口 弘也	taniguchi_hironari@example.com	広島県
奈良 あや子	nara_ayako@example.com	新潟県
細井 六郎	hosoi_rokurou@example.com	岩手県
品川 茜	shinagawa_akane@example.com	岐阜県
安藤 染五郎	anndou_somegorou@example.com	大阪府
田辺 健	tanabe_ken@example.com	愛知県
立花 まさみ	tachibana_masami@example.com	神奈川県
原 美幸	hara_miyuki@example.com	福岡県
金井 小雁	kanai_kogan@example.com	山形県
牧瀬 まさし	makise_masashi@example.com	愛知県
中谷 寿々花	nakatani_suzuka@example.com	大阪府
石垣 勝久	ishigaki_katsuhisa@example.com	富山県
海野 理紗	umino_risa@example.com	福岡県
香川 サンタマリア	kagawa_stmaria@example.com	東京都
小沼 克実	konuma_katsumi@example.com	愛媛県
深沢 聖陽	fukazawa_masaaki@example.com	東京都
勝地 ノブヒコ	katsudi_nobuhiko@example.com	愛媛県
松岡 綾	matsuoka_aya@example.com	愛知県
岡本 博明	okamoto_hiroaki@example.com	埼玉県
平沢 ジョージ	hirasawa_george@example.com	神奈川県
沖田 瞬	okita_shun@example.com	大阪府
石渡 咲	ishiwatari_saki@example.com	千葉県
尾崎 洋介	ozaki_yousuke@example.com	広島県
柴咲 美智子	shibasaki_michiko@example.com	大阪府
松尾 まひる	matsuo_mahiru@example.com	三重県
金丸 さとみ	kanamaru_satomi@example.com	山梨県
山上 なつみ	yamagami_natsumi@example.com	静岡県
青野 竜也	aono_tatsuya@example.com	神奈川県
井口 晴臣	iguchi_haruomi@example.com	愛知県
森口 菜々美	moriguchi_nanami@example.com	鳥取県
山崎 雅彦	yamazaki_masahiko@example.com	広島県
金山 くるみ	kanayama_kurumi@example.com	兵庫県
上田 コウ	ueda_kou@example.com	東京都
森島 コウ	morishima_kou@example.com	東京都
妹尾 知世	seo_chise@example.com	福岡県
桑原 法子	kuwabara_noriko@example.com	埼玉県
石塚 玲那	ishiduka_rena@example.com	千葉県
玉田 那奈	tamada_nana@example.com	静岡県
磯野 麻緒	isono_mao@example.com	島根県
中島 真希	nakashima_maki@example.com	徳島県
砂川 仁晶	sunakawa_hiroaki@example.com	長野県
板倉 ヒロ	itakura_hiro@example.com	広島県
宮内 亜希	miyauchi_aki@example.com	大阪府
長友 茂樹	nagatomo_shigeki@example.com	新潟県
千葉 恵子	chiba_keiko@example.com	新潟県
窪塚 獅童	kuboduka_shidou@example.com	香川県
丹野 あさみ	tannno_asami@example.com	京都府
久米 ジローラモ	kume_girolamo@example.com	北海道
青木 正義	aoki_masayoshi@example.com	徳島県
宮田 佑	miyata_tasuku@example.com	東京都
仲田 里奈	nakata_rina@example.com	埼玉県
山根 憲史	yamane_norihito@example.com	三重県
谷川 了	tanikawa_ryou@example.com	千葉県
長島 ひとり	nagashima_hitori@example.com	鹿児島県
長尾 咲	nagao_saki@example.com	愛知県
足立 洋	adachi_you@example.com	茨城県
池上 さやか	ikegami_sayaka@example.com	埼玉県
堀北 さんま	horikita_sanma@example.com	千葉県
玉木 恭子	tamaki_kyouko@example.com	大阪府
藤木 将也	fujiki_masaya@example.com	広島県
山村 茜	yamamura_akane@example.com	埼玉県
片桐 莉央	katagiri_rio@example.com	大阪府
板橋 明宏	itabashi_akihiro@example.com	大阪府
今野 菊生	imano_kikuo@example.com	東京都
北原 恵子	kitahara_keiko@example.com	東京都
高畑 花	takabata_hana@example.com	北海道
芳賀 晋也	haga_shinya@example.com	愛知県
今 えみ	ima_emi@example.com	茨城県
小木 努	ogi_tsutomu@example.com	岩手県
松山 愛子	matsuyama_aiko@example.com	新潟県
青木 美幸	aoki_miyuki@example.com	三重県
安座間 愛梨	azama_airi@example.com	東京都
西野 涼	nishino_ryou@example.com	埼玉県
山崎 さんま	yamazaki_sanma@example.com	鹿児島県
金丸 明	kanamaru_akira@example.com	長崎県
平尾 光	hirao_hikaru@example.com	岡山県
野上 広之	nogami_hiroyuki@example.com	北海道
関 信輔	seki_shinsuke@example.com	神奈川県
岩井 結衣	iwai_yui@example.com	千葉県
福山 完爾	fukuyama_kanji@example.com	岡山県
大浦 惇	ooura_atsushi@example.com	高知県
藤島 鉄洋	fujishima_tetsuhiro@example.com	埼玉県
島 扶樹	shima_motoki@example.com	東京都
岩井 博明	iwai_hiroaki@example.com	大阪府
相原 季衣	aihara_toshie@example.com	山口県
金丸 悟志	kanamaru_satoshi@example.com	大阪府
植田 博之	ueta_hiroyuki@example.com	大阪府
神崎 誠治	kannzaki_seiji@example.com	神奈川県
井本 守	imoto_mamoru@example.com	大阪府
小峰 美里	komine_miri@example.com	神奈川県
紺野 浩正	konno_hiromasa@example.com	福島県
笠原 美嘉	kasahara_mika@example.com	岐阜県
古田 雅彦	furuta_masahiko@example.com	千葉県
原 竜也	hara_tatsuya@example.com	石川県
長崎 那奈	nagasaki_nana@example.com	福岡県
岩村 新太	iwamura_arata@example.com	大分県
小室 恵望子	komuro_emiko@example.com	愛知県
尾上 三省	ogami_sansei@example.com	北海道
奥寺 広之	okudera_hiroyuki@example.com	北海道
内山 雅彦	uchiyama_masahiko@example.com	神奈川県
市原 昌代	ichihara_masayo@example.com	愛知県
津川 陽介	tsugawa_yousuke@example.com	神奈川県
戎 将也	ebisu_masaya@example.com	群馬県
石田 菜々美	ishida_nanami@example.com	鹿児島県
一木 はじめ	ichiki_hajime@example.com	岐阜県
和泉 麻緒	waizumi_mao@example.com	京都府
松岡 優	matsuoka_yuu@example.com	東京都
おかやま 長利	okayama_nagatoshi@example.com	兵庫県
寺本 真帆	teramoto_maho@example.com	愛知県
市川 瞬	ichikawa_shun@example.com	福島県
三浦 晃司	miura_kouji@example.com	神奈川県
豊田 広之	toyota_hiroyuki@example.com	埼玉県
長尾 完爾	nagao_kanji@example.com	大阪府
藤村 獅童	fujimura_shidou@example.com	新潟県
小泉 樹里	koizumi_juri@example.com	岡山県
板橋 隆	itabashi_takashi@example.com	和歌山県
宮原 直人	miyahara_naoto@example.com	神奈川県
米沢 敦	yonezawa_atsushi@example.com	石川県
国分 みあ	kokubunn_mia@example.com	大阪府
市川 丈史	ichikawa_takeshi@example.com	東京都
阿井 勇一	ai_yuuichi@example.com	栃木県
古川 一徳	furukawa_ittoku@example.com	愛知県
小栗 優	oguri_yuu@example.com	岐阜県
西 知世	nishi_chise@example.com	大阪府
末永 惇	suenaga_jun@example.com	大分県
出口 沙知絵	deguchi_sachie@example.com	山形県
伊藤 充則	itou_mitsunori@example.com	大分県
坂東 瞳	banntou_hitomi@example.com	宮崎県
五大 隆太	godai_ryuuta@example.com	広島県
須田 右京	suda_ukyou@example.com	愛媛県
増井 栄一	masui_eiichi@example.com	埼玉県
笹川 右京	sasagawa_ukyou@example.com	神奈川県
奥田 知世	okuda_chise@example.com	福岡県
多岐川 真吾	takigawa_shingo@example.com	長崎県
堀越 路子	horikoshi_michiko@example.com	新潟県
竹村 礼子	takemura_reiko@example.com	高知県
小沢 奈央	ozawa_nao@example.com	福岡県
石橋 誠治	ishibashi_seiji@example.com	長崎県
安座間 栄一	azama_eiichi@example.com	愛知県
窪田 和香	kubota_waka@example.com	和歌山県
前島 拓郎	maejima_takurou@example.com	長野県
菅野 真帆	sugano_maho@example.com	大阪府
安永 ヒカル	yasunaga_hikaru@example.com	愛知県
出口 三省	deguchi_sansei@example.com	埼玉県
釈 まみ	shaku_mami@example.com	長崎県
勝又 えみ	katsumata_emi@example.com	東京都
山中 雅彦	yamanaka_masahiko@example.com	広島県
高松 誠治	takamatsu_seiji@example.com	大阪府
大城 染五郎	ooshiro_somegorou@example.com	千葉県
内藤 真希	naitou_maki@example.com	静岡県
手塚 優一	teduka_yuuichi@example.com	奈良県
茂木 早紀	mogi_saki@example.com	兵庫県
亀井 みあ	kamei_mia@example.com	徳島県
立花 薫	tachibana_kaoru@example.com	千葉県
大河内 竜也	ookouchi_tatsuya@example.com	埼玉県
今西 樹里	imanishi_juri@example.com	京都府
出口 菜摘	deguchi_natsumi@example.com	宮崎県
中西 れいな	nakanishi_reina@example.com	福井県
宮本 真一	miyamoto_shinichi@example.com	岡山県
前野 三省	maeno_sansei@example.com	福岡県
平林 景子	hirabayashi_keiko@example.com	静岡県
神崎 雅彦	kannzaki_masahiko@example.com	広島県
西沢 優	nishizawa_yuu@example.com	福岡県
奥村 綾女	okumura_ayame@example.com	京都府
松井 由樹	matsui_yuki@example.com	千葉県
外山 充則	sotoyama_mitsunori@example.com	大阪府
氏家 菜摘	ujiie_natsumi@example.com	埼玉県
西谷 あや子	nishiya_ayako@example.com	茨城県
畑中 樹里	hatanaka_juri@example.com	千葉県
市川 杏	ichikawa_ann@example.com	埼玉県
藤本 小百合	fujimoto_sayuri@example.com	福岡県
森永 三省	morinaga_sansei@example.com	埼玉県
高岡 将也	takaoka_masaya@example.com	千葉県
小泉 真帆	koizumi_maho@example.com	東京都
高松 小百合	takamatsu_sayuri@example.com	青森県
小菅 憲史	kosuge_norihito@example.com	兵庫県
渋谷 良介	shibuya_ryousuke@example.com	佐賀県
吉永 慢太郎	yoshinaga_mantarou@example.com	大阪府
深谷 南朋	fukaya_nao@example.com	京都府
瀬戸内 隼士	setouchi_shunji@example.com	東京都
北条 一哉	houjou_kazuya@example.com	埼玉県
岩谷 直人	iwatani_naoto@example.com	北海道
広末 彩	hirosue_aya@example.com	愛知県
生瀬 兼	namase_ken@example.com	青森県
古田 晴臣	furuta_haruomi@example.com	山形県
中島 法嗣	nakajima_houshi@example.com	新潟県
岩佐 徹	iwasa_tohru@example.com	千葉県
角田 景子	kadota_keiko@example.com	長野県
照井 陽介	terui_yousuke@example.com	新潟県
蒼井 サダヲ	aoi_sadawo@example.com	埼玉県
金城 康文	kanashiro_yasufumi@example.com	神奈川県
板橋 勝久	itabashi_katsuhisa@example.com	神奈川県
武藤 ジローラモ	mutou_girolamo@example.com	愛知県
松本 愛菜	matsumoto_aina@example.com	大阪府
久保田 綾女	kubota_ayame@example.com	千葉県
吉岡 正敏	yoshioka_masatoshi@example.com	神奈川県
岩崎 光洋	iwasaki_mitsuhiro@example.com	兵庫県
大原 誠治	oohara_seiji@example.com	東京都
前田 菊生	maeda_kikuo@example.com	高知県
藤原 なつみ	fujiwara_natsumi@example.com	京都府
熊谷 めぐみ	kumagaya_megumi@example.com	茨城県
岩村 草太	iwamura_souta@example.com	大阪府
丸田 まさし	maruta_masashi@example.com	香川県
金丸 賢二	kanamaru_kenji@example.com	長崎県
赤木 隼士	akagi_shunji@example.com	愛知県
石川 ちえみ	ishikawa_chiemi@example.com	長野県
沼田 茂樹	numata_shigeki@example.com	群馬県
森谷 優	moriya_yuu@example.com	千葉県
香川 聡	kagawa_satoshi@example.com	愛知県
村松 瞬	muramatsu_shun@example.com	神奈川県
石田 愛子	ishida_aiko@example.com	愛知県
奥田 あおい	okuda_aoi@example.com	宮崎県
葛西 利夫	kasai_toshio@example.com	京都府
柏木 杏	kashiwagi_ann@example.com	兵庫県
ほしの 麗奈	hoshino_rena@example.com	神奈川県
青野 サダヲ	aono_sadawo@example.com	大分県
杉本 裕次郎	sugimoto_yuujirou@example.com	兵庫県
藤原 公顕	fujiwara_kimiaki@example.com	愛知県
重松 裕司	shigematsu_yuuji@example.com	栃木県
丹羽 剛基	tannba_yoshiki@example.com	茨城県
明石 みき	akashi_miki@example.com	福岡県
浦野 竜也	urano_tatsuya@example.com	埼玉県
高木 愛菜	takagi_aina@example.com	愛知県
岡島 圭	okajima_kei@example.com	東京都
大浦 一徳	ooura_ittoku@example.com	岡山県
白川 孝太郎	shirakawa_koutarou@example.com	北海道
小池 紗季	koike_saki@example.com	兵庫県
飯野 春樹	iino_haruki@example.com	新潟県
武 陽子	take_youko@example.com	福岡県
福島 育二	fukushima_ikuji@example.com	兵庫県
小野 真一	ono_shinichi@example.com	愛知県
島津 美幸	shimadu_miyuki@example.com	兵庫県
脇田 瑠璃亜	wakita_ruria@example.com	神奈川県
川村 結衣	kawamura_yui@example.com	兵庫県
杉浦 亜希	sugiura_aki@example.com	東京都
富岡 あさみ	tomioka_asami@example.com	茨城県
照井 広之	terui_hiroyuki@example.com	大分県
滝沢 郁恵	takizawa_ikue@example.com	熊本県
村松 正敏	muramatsu_masatoshi@example.com	三重県
金井 ひろ子	kanai_hiroko@example.com	埼玉県
田中 ひろみ	tanaka_hiromi@example.com	大阪府
高岡 徹	takaoka_tooru@example.com	愛知県
児島 えみ	kojima_emi@example.com	神奈川県
宮川 仁	miyakawa_jin@example.com	徳島県
三井 完爾	mitsui_kanji@example.com	岡山県
長谷川 進	hasegawa_susumu@example.com	群馬県
谷川 優	tanikawa_yuu@example.com	岡山県
中島 慶太	nakajima_keita@example.com	愛知県
黒川 杏	kurokawa_ann@example.com	京都府
佐伯 夏空	saeki_sora@example.com	千葉県
藤原 有起哉	fujiwara_yukiya@example.com	茨城県
永島 朝陽	nagashima_asahi@example.com	新潟県
森島 まさみ	morishima_masami@example.com	山口県
水崎 京子	misaki_kyouko@example.com	兵庫県
高原 和久	takahara_kazuhisa@example.com	福岡県
吉原 法嗣	yoshiwara_houshi@example.com	沖縄県
寺島 明宏	terajima_akihiro@example.com	大阪府
今川 孝太郎	imagawa_koutarou@example.com	愛知県
脇田 陽介	wakita_yousuke@example.com	神奈川県
大竹 陽介	ootake_yousuke@example.com	宮崎県
手塚 夏希	teduka_natsuki@example.com	愛知県
富沢 さやか	tomisawa_sayaka@example.com	広島県
田所 優	tadokoro_yuu@example.com	神奈川県
小池 那奈	koike_nana@example.com	愛知県
岸部 沙知絵	kishibe_sachie@example.com	長野県
西田 菜摘	nishida_natsumi@example.com	神奈川県
大城 美希	ooshiro_miki@example.com	栃木県
土居 祐基	doi_yuuki@example.com	宮崎県
満島 明	mitsushima_akira@example.com	広島県
土井 正敏	doi_masatoshi@example.com	福岡県
細川 洋介	hosokawa_yousuke@example.com	群馬県
長崎 知世	nagasaki_chise@example.com	愛知県
並木 兼	namiki_ken@example.com	北海道
安斎 優	annzai_yuu@example.com	福島県
田淵 一樹	tabuchi_kazuki@example.com	福岡県
片山 真帆	katayama_maho@example.com	広島県
乾 研二	inui_kenji@example.com	群馬県
岡山 倫子	okayama_noriko@example.com	兵庫県
竹村 美嘉	takemura_mika@example.com	東京都
田原 知世	tahara_chise@example.com	高知県
北川 努	kitakawa_tsutomu@example.com	兵庫県
川端 染五郎	kawabata_somegorou@example.com	岩手県
藤村 祐基	fujimura_yuuki@example.com	千葉県
柳家 麻緒	yanagiya_mao@example.com	東京都
福地 くるみ	fukuchi_kurumi@example.com	北海道
井口 茂樹	iguchi_shigeki@example.com	長野県
峰 美咲	mine_misaki@example.com	北海道
出口 光	deguchi_hikaru@example.com	広島県
村山 さんま	murayama_sanma@example.com	宮城県
中 新太	naka_arata@example.com	神奈川県
深田 なつみ	fukada_natsumi@example.com	徳島県
安達 涼	adachi_ryou@example.com	大阪府
戸田 詩織	toda_shiori@example.com	富山県
パンツェッタ 雅彦	panzetta_masahiko@example.com	愛知県
富田 祐一	tomita_yuuichi@example.com	埼玉県
岡田 美幸	okada_miyuki@example.com	東京都
三井 樹里	mitsui_juri@example.com	栃木県
市川 砂羽	ichikawa_sawa@example.com	神奈川県
坂田 弘也	sakata_hironari@example.com	北海道
芹沢 人志	serizawa_hitoshi@example.com	千葉県
飛田 早織	hida_saori@example.com	滋賀県
金谷 碧海	kanaya_ouga@example.com	愛知県
邑野 鉄二	murano_tetsuji@example.com	北海道
高岡 直人	takaoka_naoto@example.com	福島県
岡山 薫	okayama_kaoru@example.com	佐賀県
深田 明	fukada_akira@example.com	宮崎県
松井 明日	matsui_meibi@example.com	富山県
一木 研二	ichiki_kenji@example.com	岐阜県
長谷部 奈々	hasebe_nana@example.com	東京都
城戸 れいな	kido_reina@example.com	埼玉県
寺沢 結子	terasawa_yuuko@example.com	静岡県
林 メイサ	hayashi_meisa@example.com	東京都
木下 拓郎	kinoshita_takurou@example.com	岡山県
岩淵 啓介	iwabuchi_keisuke@example.com	大阪府
下川 幸平	shimokawa_kouhei@example.com	兵庫県
水崎 夏空	misaki_sora@example.com	東京都
武田 七世	takeda_nanase@example.com	東京都
桑田 公顕	kuwata_kimiaki@example.com	佐賀県
渋谷 宏	shibuya_hiroshi@example.com	長野県
細川 一哉	hosokawa_kazuya@example.com	神奈川県
田上 未來	taue_mirai@example.com	沖縄県
江藤 さゆり	etou_sayuri@example.com	三重県
小松 菜々美	komatsu_nanami@example.com	山梨県
影山 祐一	kageyama_yuuichi@example.com	茨城県
阪口 真希	sakaguchi_maki@example.com	島根県
成瀬 玲那	naruse_rena@example.com	埼玉県
高野 礼子	takano_reiko@example.com	徳島県
伊丹 遥	itami_haruka@example.com	山梨県
古屋 法嗣	furuya_houshi@example.com	兵庫県
桑田 莉緒	kuwata_rio@example.com	群馬県
中山 なつみ	nakayama_natsumi@example.com	長崎県
日高 朝香	hidaka_asaka@example.com	京都府
相沢 研二	aizawa_kenji@example.com	神奈川県
熊田 愛子	kumada_aiko@example.com	北海道
小野田 サンタマリア	onoda_stmaria@example.com	秋田県
武藤 なぎさ	mutou_nagisa@example.com	愛媛県
藤崎 ひろみ	fujisaki_hiromi@example.com	鹿児島県
丸田 明宏	maruta_akihiro1@example.com	兵庫県
石黒 聖陽	ishiguro_masaaki@example.com	大分県
坪井 勝久	tsuboi_katsuhisa@example.com	石川県
今川 サンタマリア	imagawa_stmaria@example.com	沖縄県
水嶋 和香	mizushima_waka@example.com	三重県
八木 さやか	yagi_sayaka@example.com	福岡県
滝 鉄二	taki_tetsuji@example.com	千葉県
細野 優	hosono_yuu@example.com	東京都
川添 隼士	kawazoe_shunji@example.com	福岡県
三輪 憲史	miwa_norihito@example.com	千葉県
布川 奈々	fukawa_nana@example.com	東京都
福山 仁晶	fukuyama_hiroaki@example.com	岩手県
吉沢 太朗	yoshizawa_tarou@example.com	宮城県
西山 華子	nishiyama_hanako@example.com	石川県
安田 あや子	yasuda_ayako@example.com	埼玉県
田辺 聡	tanabe_satoshi@example.com	和歌山県
秋葉 寛	akiba_hiroshi@example.com	茨城県
進藤 鉄二	shinndou_tetsuji@example.com	長崎県
加瀬 ひかり	kase_hikari@example.com	大阪府
山村 朝陽	yamamura_asahi@example.com	東京都
板倉 綾	itakura_aya@example.com	秋田県
曽根 奈々	sone_nana@example.com	宮崎県
市川 陽子	ichikawa_youko@example.com	福岡県
勝又 豊	katsumata_yutaka@example.com	大阪府
田畑 コウ	tabata_kou@example.com	千葉県
玉木 貴嶺	tamaki_takane@example.com	愛知県
島崎 彩	shimazaki_aya@example.com	東京都
大庭 光良	ooniwa_teruyoshi@example.com	福岡県
吉永 あさみ	yoshinaga_asami@example.com	宮城県
竹原 まひる	takehara_mahiru@example.com	広島県
保坂 きみまろ	hosaka_kimimaro@example.com	北海道
梅原 晃司	umehara_kouji@example.com	宮崎県
畠山 宏行	hatayama_hiroyuki@example.com	滋賀県
植田 倫子	ueta_noriko@example.com	愛媛県
福士 麻緒	fukushi_mao@example.com	宮城県
角田 浩太郎	kadota_koutarou@example.com	北海道
小室 あき	komuro_aki@example.com	鳥取県
神木 優	kamiki_yuu@example.com	愛媛県
関口 茜	sekiguchi_akane@example.com	茨城県
島崎 新太	shimazaki_arata@example.com	埼玉県
高瀬 京子	takase_kyouko@example.com	栃木県
牧田 寛治	makita_kanji@example.com	神奈川県
谷本 奈月	tanimoto_natsuki@example.com	大阪府
吉野 奈々	yoshino_nana@example.com	石川県
黒崎 ひろ子	kurosaki_hiroko@example.com	大分県
諏訪 薫	suwa_kaoru@example.com	山口県
寺本 蒼甫	teramoto_sousuke@example.com	愛知県
小口 丈史	oguchi_takeshi@example.com	滋賀県
町田 茜	machida_akane@example.com	奈良県
長谷 隼士	nagaya_shunji@example.com	広島県
富沢 裕司	tomisawa_yuuji@example.com	岡山県
田中 あい	tanaka_ai@example.com	石川県
高木 慢太郎	takagi_mantarou@example.com	新潟県
神崎 聖陽	kannzaki_masaaki@example.com	静岡県
平塚 涼	hiratsuka_ryou@example.com	北海道
北野 祐一	kitano_yuuichi@example.com	愛知県
細谷 雅功	hosoya_masatoshi@example.com	神奈川県
丹羽 茂樹	tannba_shigeki@example.com	兵庫県
長友 璃子	nagatomo_riko@example.com	新潟県
福島 コウ	fukushima_kou@example.com	愛知県
目黒 花緑	meguro_karoku@example.com	大阪府
浜田 基祐	hamada_kisuke@example.com	千葉県
本田 まひる	honnda_mahiru@example.com	福岡県
首藤 遥	sudou_haruka@example.com	神奈川県
真鍋 大五郎	manabe_daigorou@example.com	兵庫県
内海 さとみ	uchimi_satomi@example.com	東京都
三沢 徹	misawa_tooru@example.com	神奈川県
日比野 ちえみ	hibino_chiemi@example.com	岡山県
青木 薫	aoki_kaoru@example.com	栃木県
堀 洋	hori_you@example.com	大阪府
布施 薫	fuse_kaoru@example.com	東京都
臼井 弘也	usui_hironari@example.com	滋賀県
細川 陽子	hosokawa_youko@example.com	神奈川県
西口 さやか	nishiguchi_sayaka@example.com	東京都
中本 ジローラモ	nakamoto_girolamo@example.com	秋田県
松浦 さとみ	matsuura_satomi@example.com	兵庫県
海音寺 友香	kaionji_tomoka@example.com	青森県
本間 知世	honma_chise@example.com	島根県
中田 結子	nakata_yuuko@example.com	東京都
釈 幸平	shaku_kouhei@example.com	香川県
栗原 勝久	kurihara_katsuhisa@example.com	神奈川県
永島 扶樹	nagashima_motoki@example.com	滋賀県
三村 扶樹	mimura_motoki@example.com	栃木県
片瀬 敏也	katase_toshiya@example.com	新潟県
上田 薫	ueda_kaoru@example.com	大分県
大原 恵美	oohara_megumi@example.com	兵庫県
五大 草太	godai_souta@example.com	静岡県
松原 明宏	matsubara_akihiro@example.com	山梨県
川原 麻緒	kawahara_mao@example.com	山口県
関口 樹里	sekiguchi_juri@example.com	茨城県
森井 公顕	morii_kimiaki@example.com	東京都
大滝 龍吉	ootaki_ryuukichi@example.com	香川県
藤木 知世	fujiki_chise@example.com	石川県
石田 敏也	ishida_toshiya@example.com	埼玉県
入江 美菜	irie_mina@example.com	神奈川県
津川 草太	tsugawa_souta@example.com	神奈川県
平沢 良介	hirasawa_ryousuke@example.com	和歌山県
金山 竜也	kanayama_tatsuya@example.com	滋賀県
紺野 豊	konnno_yutaka@example.com	滋賀県
今井 莉緒	imai_rio@example.com	茨城県
小町 勝久	komachi_katsuhisa@example.com	神奈川県
橋口 陽子	hashiguchi_youko@example.com	埼玉県
大場 和久	ooba_kazuhisa@example.com	東京都
下山 京子	shimoyama_kyouko@example.com	東京都
田沢 拓郎	tazawa_takurou@example.com	東京都
橋口 陽介	hashiguchi_yousuke@example.com	兵庫県
多岐川 了	takigawa_ryou@example.com	千葉県
松山 華子	matsuyama_hanako@example.com	兵庫県
大庭 雅彦	ooniwa_masahiko@example.com	高知県
浜 マサカズ	hama_masakazu@example.com	福岡県
野田 さんま	noda_sanma@example.com	新潟県
馬場 聡	baba_satoshi@example.com	大阪府
藤原 そら	fujiwara_sora@example.com	岐阜県
田原 玲那	tahara_rena@example.com	愛知県
堀井 俊介	horii_shunsuke@example.com	岐阜県
神田 雄太	kannda_yuuta@example.com	北海道
八田 功補	yatsuda_kousuke@example.com	東京都
堤 哲平	tsutsumi_teppei@example.com	滋賀県
大貫 真一	oonuki_shinichi@example.com	兵庫県
門脇 希	kadowaki_nozomi@example.com	高知県
米沢 知史	yonezawa_tomofumi@example.com	福島県
柳田 大五郎	yanagida_daigorou@example.com	東京都
松村 一	matsumura_hajime@example.com	神奈川県
西浦 奈央	nishiura_nao@example.com	長野県
長島 碧海	nagashima_ouga@example.com	東京都
上野 竜也	ueno_tatsuya@example.com	静岡県
若山 翔子	wakayama_shouko@example.com	千葉県
藤井 しぼり	fujii_shibori@example.com	神奈川県
藤井 明	fujii_akira@example.com	神奈川県
井出 真希	ide_maki@example.com	北海道
井上 ヒロ	inoue_hiro@example.com	東京都
高島 明	takashima_akira@example.com	長崎県
熊倉 裕司	kumakura_yuuji@example.com	秋田県
宍戸 あさみ	shishido_asami@example.com	神奈川県
大地 美佐	oochi_misa@example.com	東京都
根岸 健	negishi_ken@example.com	東京都
草野 貴嶺	kusano_takane@example.com	大阪府
藤木 美紀	fujiki_miki@example.com	愛知県
亀山 さやか	kameyama_sayaka@example.com	東京都
鹿手袋 あおい	shikatebukuro_aoi@example.com	富山県
大森 育二	oomori_ikuji@example.com	東京都
安座間 そら	azama_sora@example.com	新潟県
小野田 友香	onoda_tomoka@example.com	千葉県
浜口 しぼり	hamaguchi_shibori@example.com	三重県
木村 千夏	kimura_chinatsu@example.com	群馬県
竹中 一代	takenaka_kazuyo@example.com	東京都
渋谷 りえ	shibuya_rie@example.com	岐阜県
平岡 貴美子	hiraoka_kimiko@example.com	群馬県
関根 洋介	sekine_yousuke@example.com	京都府
林田 友也	hayashida_tomoya@example.com	東京都
秋田 惇	akita_atsushi@example.com	福井県
白石 美智子	shiraishi_michiko@example.com	長崎県
松谷 綾女	matsutani_ayame@example.com	大阪府
谷本 窈	tanimoto_you@example.com	静岡県
高崎 知世	takasaki_chise@example.com	茨城県
矢作 恵梨香	yahagi_erika@example.com	東京都
石垣 瑠璃亜	ishigaki_ruria@example.com	東京都
市川 昌代	ichikawa_masayo@example.com	岩手県
浅倉 六郎	asakura_rokurou@example.com	大阪府
小原 菜々美	ohara_nanami@example.com	東京都
矢作 恵麻	yahagi_ema@example.com	埼玉県
曽根 南朋	sone_nao@example.com	和歌山県
石橋 慶二	ishibashi_keiji@example.com	福岡県
下田 はるか	shimoda_haruka@example.com	福岡県
藤田 彩	fujita_aya@example.com	愛知県
玉置 拓郎	tamaki_takurou@example.com	神奈川県
若杉 郁恵	wakasugi_ikue@example.com	広島県
小菅 法嗣	kosuge_houshi@example.com	千葉県
高樹 直人	takagi_naoto@example.com	愛知県
勝田 昴	katsuda_subaru@example.com	新潟県
中野 希	nakano_nozomi@example.com	茨城県
海老原 聡	ebihara_satoshi@example.com	香川県
阪本 康文	sakamoto_yasufumi@example.com	兵庫県
島田 夏空	shimada_sora@example.com	福岡県
市田 美幸	ichida_miyuki@example.com	神奈川県
小西 美佐	konishi_misa@example.com	三重県
山中 宏行	yamanaka_hiroyuki@example.com	愛知県
三上 きみまろ	mikami_kimimaro@example.com	静岡県
磯村 大	isomura_masaru@example.com	長野県
村中 博之	muranaka_hiroyuki@example.com	大阪府
宮原 隼士	miyahara_shunji@example.com	北海道
川中 さゆり	kawanaka_sayuri@example.com	埼玉県
勝又 光	katsumata_hikaru@example.com	和歌山県
古山 メイサ	furuyama_meisa@example.com	千葉県
寺井 景子	terai_keiko@example.com	神奈川県
足立 友香	adachi_tomoka@example.com	愛知県
川端 朝陽	kawabata_asahi@example.com	和歌山県
小西 れいな	konishi_reina@example.com	福岡県
川畑 サンタマリア	kawahata_stmaria@example.com	沖縄県
小沢 まさみ	ozawa_masami@example.com	東京都
吉崎 花	yoshizaki_hana@example.com	東京都
小森 明	komori_akira@example.com	神奈川県
山中 杏	yamanaka_ann@example.com	熊本県
田代 ケンイチ	tashiro_kenichi@example.com	東京都
井田 愛子	ida_aiko@example.com	石川県
長野 ひろ子	nagano_hiroko@example.com	長野県
三沢 雅彦	misawa_masahiko@example.com	東京都
進藤 満	shinndou_mitsuru@example.com	愛知県
小沢 夏希	ozawa_natsuki@example.com	埼玉県
小松 亜希	komatsu_aki@example.com	大阪府
西原 菜々美	nishihara_nanami@example.com	千葉県
堀 啓介	hori_keisuke@example.com	東京都
河西 鉄二	kawanishi_tetsuji@example.com	長野県
宮田 早織	miyata_saori@example.com	京都府
高村 隆	takamura_takashi@example.com	兵庫県
筧 真一	kakei_shinichi@example.com	岐阜県
富田 徹	tomita_tooru@example.com	奈良県
梅本 守	umemoto_mamoru@example.com	静岡県
植村 高史	uemura_takashi@example.com	三重県
矢作 淳	yahagi_atsushi@example.com	京都府
山田 あや子	yamada_ayako@example.com	神奈川県
柴田 染五郎	shibata_somegorou@example.com	茨城県
藤崎 博明	fujisaki_hiroaki@example.com	神奈川県
松沢 あき	matsuzawa_aki@example.com	愛知県
正木 一代	masaki_kazuyo@example.com	静岡県
畑中 マサカズ	hatanaka_masakazu@example.com	大阪府
中 はるか	naka_haruka@example.com	静岡県
中原 真奈美	nakahara_manami@example.com	高知県
本山 奈央	honnyama_nao@example.com	兵庫県
川本 貴嶺	kawamoto_takane@example.com	宮城県
梶原 希	kajiwara_nozomi@example.com	静岡県
河野 洋	kawano_you@example.com	東京都
浅野 大五郎	asano_daigorou@example.com	北海道
石本 翔太	ishimoto_shouta@example.com	大阪府
植木 芽以	ueki_mei@example.com	神奈川県
木戸 鉄洋	kido_tetsuhiro@example.com	福岡県
瀬戸 優一	seto_yuuichi@example.com	青森県
池内 里奈	ikeuchi_rina@example.com	兵庫県
本間 陽子	honnma_youko@example.com	東京都
大滝 碧海	ootaki_ouga@example.com	福岡県
秦 隆博	hata_takahiro@example.com	北海道
柴咲 瞳	shibasaki_hitomi@example.com	山口県
竹本 惇	takemoto_jun@example.com	北海道
岡野 礼子	okano_reiko@example.com	東京都
白井 法嗣	shirai_houshi@example.com	北海道
内村 未來	uchimura_mirai@example.com	神奈川県
三宅 直人	miyake_naoto@example.com	愛知県
津田 まみ	tsuda_mami@example.com	茨城県
横井 彩華	yokoi_ayaka@example.com	東京都
染谷 豊	someya_yutaka@example.com	神奈川県
樋口 基祐	higuchi_kisuke@example.com	山梨県
山川 ちえみ	yamakawa_chiemi@example.com	京都府
富山 友也	tomiyama_tomoya@example.com	茨城県
藤村 祐一	fujimura_yuuichi@example.com	埼玉県
高畑 早織	takabata_saori@example.com	東京都
岩城 ケンイチ	iwaki_kenichi@example.com	千葉県
橋本 沙知絵	hashimoto_sachie@example.com	大阪府
小倉 光洋	ogura_mitsuhiro@example.com	広島県
柄本 れいな	emoto_reina@example.com	千葉県
杉本 知史	sugimoto_tomofumi@example.com	北海道
徳重 沙耶	tokushige_saya@example.com	千葉県
田川 明慶	tagawa_akiyoshi@example.com	富山県
染谷 未來	someya_mirai@example.com	愛知県
田口 しほり	taguchi_shihori@example.com	京都府
小森 あや子	komori_ayako@example.com	北海道
大坂 優	oosaka_yuu@example.com	兵庫県
半田 茜	hannda_akane@example.com	岡山県
長沢 大五郎	nagasawa_daigorou@example.com	三重県
熊倉 研二	kumakura_kenji@example.com	静岡県
丹野 聡	tannno_satoshi@example.com	島根県
高谷 有海	takaya_ami@example.com	福井県
岡島 洋介	okajima_yousuke@example.com	京都府
秋元 功補	akimoto_kousuke@example.com	栃木県
武藤 鉄洋	mutou_tetsuhiro@example.com	鹿児島県
島村 祐一	shimamura_yuuichi@example.com	秋田県
松本 新太	matsumoto_arata@example.com	石川県
矢沢 裕次郎	yazawa_yuujirou@example.com	東京都
葛西 徹平	kasai_teppei@example.com	福岡県
鈴木 真一	suzuki_shinichi@example.com	東京都
西尾 雄太	nishio_yuuta@example.com	岡山県
金児 丈史	kaneko_takeshi@example.com	北海道
田中 晴臣	tanaka_haruomi@example.com	秋田県
今田 和之	imada_kazuyuki@example.com	福岡県
石黒 春樹	ishiguro_haruki@example.com	石川県
戸塚 精児	toduka_seiji@example.com	滋賀県
相川 憲一	aikawa_kenichi@example.com	北海道
西原 竜次	nishihara_ryuuji@example.com	宮城県
神保 悟志	jinbo_satoshi@example.com	岡山県
奥寺 丈史	okudera_takeshi@example.com	東京都
荒井 浩太郎	arai_koutarou@example.com	大阪府
河野 優	kawano_yuu@example.com	東京都
鬼頭 美希	kitou_miki@example.com	東京都
倉持 あき	kuramochi_aki@example.com	東京都
豊島 優一	toyoshima_yuuichi@example.com	広島県
井沢 ちえみ	izawa_chiemi@example.com	神奈川県
矢田 瑠璃亜	yada_ruria@example.com	福岡県
高樹 彩	takagi_aya@example.com	埼玉県
秋葉 憲一	akiba_kenichi@example.com	北海道
佐々木 碧海	sasaki_ouga@example.com	鹿児島県
野原 恵梨香	nohara_erika@example.com	三重県
高梨 隆太	takanashi_ryuuta@example.com	神奈川県
新垣 涼	aragaki_ryou@example.com	千葉県
車 真希	kuruma_maki@example.com	徳島県
緒形 信輔	ogata_shinsuke@example.com	沖縄県
金谷 一輝	kanaya_kazuki@example.com	宮城県
森島 美和子	morishima_miwako@example.com	愛知県
大沼 ジョージ	oonuma_george@example.com	東京都
後藤 宏	gotou_hiroshi@example.com	愛知県
大久保 花緑	ookubo_karoku@example.com	千葉県
浜野 麻由子	hamano_mayuko1@example.com	青森県
平田 鉄二	hirata_tetsuji@example.com	京都府
寺島 由美子	terashima_yumiko@example.com	大阪府
大後 俊二	oogo_shunji@example.com	広島県
飯田 優	iida_yuu@example.com	北海道
清野 しぼり	kiyono_shibori@example.com	大阪府
江原 妃里	ehara_yuri@example.com	宮城県
高岡 那奈	takaoka_nana@example.com	東京都
椎名 みゆき	shiina_miyuki@example.com	神奈川県
杉野 あき	sugino_aki@example.com	茨城県
藤岡 裕次郎	fujioka_yuujirou@example.com	神奈川県
井田 里奈	ida_rina@example.com	愛媛県
吉原 和香	yoshiwara_waka@example.com	茨城県
梅沢 美和子	umezawa_miwako@example.com	大阪府
宇野 南朋	uno_nao@example.com	滋賀県
岩井 康文	iwai_yasufumi@example.com	栃木県
阪口 和久	sakaguchi_kazuhisa@example.com	奈良県
黒木 禄郎	kuroki_rokurou@example.com	沖縄県
土田 里穂	tsuchida_riho@example.com	鳥取県
有田 えみ	arita_emi@example.com	福井県
武 美和子	take_miwako@example.com	島根県
足立 将也	adachi_masaya@example.com	秋田県
飛田 陽介	hida_yousuke@example.com	岐阜県
新谷 孝太郎	araya_koutarou@example.com	神奈川県
赤松 恵麻	akamatsu_ema@example.com	鹿児島県
緒方 守	ogata_mamoru@example.com	岩手県
三宅 一代	miyake_kazuyo@example.com	愛媛県
羽田 まみ	hata_mami@example.com	広島県
中島 南朋	nakajima_nao@example.com	茨城県
寺脇 亜希	terawaki_aki@example.com	高知県
池本 綾女	ikemoto_ayame@example.com	群馬県
須藤 ひかり	sudou_hikari@example.com	大阪府
藤山 莉緒	fujiyama_rio@example.com	宮崎県
尾崎 和久	ozaki_kazuhisa@example.com	東京都
滝川 鉄二	takigawa_tetsuji@example.com	鳥取県
相田 彩	aida_aya@example.com	佐賀県
西秋 啓介	nishiaki_keisuke@example.com	新潟県
倉本 崇史	kuramoto_takashi@example.com	静岡県
大坂 みゆき	oosaka_miyuki@example.com	千葉県
高木 耕司	takagi_kouji@example.com	鹿児島県
大江 晴臣	ooe_haruomi@example.com	広島県
須賀 詩織	suga_shiori@example.com	愛知県
広田 コウ	hirota_kou@example.com	福岡県
原田 満	harada_mitsuru@example.com	大阪府
八十田 美優	yasoda_myuu@example.com	宮城県
小柳 光洋	koyanagi_mitsuhiro@example.com	東京都
日野 杏	hino_ann@example.com	沖縄県
豊島 耕司	toyoshima_kouji@example.com	福岡県
有村 優一	arimura_yuuichi@example.com	石川県
矢島 新太	yajima_arata@example.com	千葉県
中本 祐一	nakamoto_yuuichi@example.com	埼玉県
田所 洋介	tadokoro_yousuke@example.com	東京都
奥田 翔太	okuda_shouta@example.com	神奈川県
池谷 さやか	iketani_sayaka@example.com	神奈川県
内野 裕次郎	uchino_yuujirou@example.com	静岡県
高山 茜	takayama_akane@example.com	福岡県
岸部 光	kishibe_hikaru@example.com	宮城県
小池 ジローラモ	koike_girolamo@example.com	福岡県
松村 薫	matsumura_kaoru@example.com	滋賀県
小田 満	oda_mitsuru@example.com	東京都
中林 慢太郎	nakabayashi_mantarou@example.com	東京都
小町 直人	komachi_naoto@example.com	大阪府
関 満	seki_mitsuru@example.com	神奈川県
岸本 さんま	kishimoto_sanma@example.com	岐阜県
深田 ジローラモ	fukada_girolamo@example.com	大阪府
横井 豊	yokoi_yutaka@example.com	愛知県
今村 直人	imamura_naoto@example.com	福島県
武内 恭子	takeuchi_kyouko@example.com	新潟県
高島 努	takashima_tsutomu@example.com	大阪府
神田 優	kannda_yuu@example.com	富山県
岡 昴	oka_subaru@example.com	島根県
倉田 一輝	kurata_kazuki@example.com	石川県
横田 美菜	yokota_mina@example.com	大阪府
松山 砂羽	matsuyama_sawa@example.com	大阪府
原田 美佐子	harada_misako@example.com	東京都
青柳 だん吉	aoyagi_dankichi@example.com	青森県
氏家 さんま	ujiie_sanma@example.com	大阪府
杉村 敦	sugimura_atsushi@example.com	神奈川県
石井 未來	ishii_mirai@example.com	兵庫県
緒形 秀樹	ogata_hideki@example.com	秋田県
戸田 研二	toda_kenji@example.com	宮城県
平田 翔	hirata_shou@example.com	北海道
赤坂 メイサ	akasaka_meisa@example.com	長崎県
大津 寛	ootsu_hiroshi@example.com	神奈川県
蒼井 文世	aoi_fumiyo@example.com	三重県
土田 ヒロ	tsuchida_hiro@example.com	滋賀県
八木 優	yagi_yuu@example.com	香川県
竹中 まさみ	takenaka_masami@example.com	東京都
柳家 優	yanagiya_yuu@example.com	富山県
高見 獅童	takami_shidou@example.com	鳥取県
北島 亮介	kitajima_ryousuke@example.com	石川県
柄本 優	emoto_yuu@example.com	神奈川県
横田 涼	yokota_ryou@example.com	大阪府
五味 恵麻	gomi_ema@example.com	神奈川県
小野寺 窈	onodera_you@example.com	福岡県
金田 功補	kaneda_kousuke@example.com	神奈川県
永島 知世	nagashima_chise@example.com	東京都
越智 はるか	ochi_haruka@example.com	神奈川県
石山 莉央	ishiyama_rio@example.com	福岡県
川井 亜希	kawai_aki@example.com	福岡県
竹中 華子	takenaka_hanako@example.com	沖縄県
赤松 光良	akamatsu_teruyoshi@example.com	広島県
日下 秀樹	hinoshita_hideki@example.com	新潟県
長谷部 まさみ	hasebe_masami@example.com	福岡県
河野 沙耶	kawano_saya@example.com	大阪府
日高 洋介	hidaka_yousuke@example.com	徳島県
車 薫	kuruma_kaoru@example.com	三重県
本村 きみまろ	honnmura_kimimaro@example.com	長崎県
高田 広司	takada_kouji@example.com	埼玉県
秋田 怜奈	akita_reina@example.com	山梨県
河合 莉沙	kawai_risa@example.com	神奈川県
大城 淳子	ooshiro_atsuko@example.com	兵庫県
西岡 光臣	nishioka_mitsuomi@example.com	熊本県
田端 美咲	tabata_misaki@example.com	青森県
長尾 郁恵	nagao_ikue@example.com	大阪府
斉藤 一恵	saitou_kadue@example.com	北海道
安斎 真悠子	annzai_mayuko@example.com	愛媛県
多部 だん吉	tabe_dankichi@example.com	千葉県
寺尾 大五郎	terao_daigorou@example.com	奈良県
大野 千佳子	oono_chikako@example.com	大阪府
内野 さんま	uchino_sanma@example.com	宮城県
真田 雅彦	sanada_masahiko@example.com	山梨県
三村 薫	mimura_kaoru@example.com	愛知県
渋谷 雅之	shibuya_masayuki@example.com	千葉県
窪田 勤	kubota_tsutomu@example.com	山口県
森田 敦	morita_atsushi1@example.com	沖縄県
中村 恵梨香	nakamura_erika@example.com	静岡県
神原 竜也	kannbara_tatsuya@example.com	大阪府
川口 幸平	kawaguchi_kouhei@example.com	京都府
塩田 れいな	shiota_reina@example.com	北海道
青木 康文	aoki_yasufumi@example.com	大阪府
浅利 聡	asari_satoshi@example.com	宮城県
坂口 寛	sakaguchi_hiroshi@example.com	北海道
北川 あき	kitagawa_aki@example.com	大阪府
浜 陽介	hama_yousuke@example.com	鹿児島県
青木 あさみ	aoki_asami@example.com	山形県
入江 翔	irie_shou@example.com	愛媛県
砂川 みあ	sunakawa_mia@example.com	青森県
大路 美佐子	ooji_misako@example.com	福岡県
岡部 明日	okabe_meibi@example.com	北海道
藤澤 綾女	fujisawa_ayame@example.com	東京都
半田 かおり	hannda_kaori@example.com	沖縄県
米田 健	yoneda_ken@example.com	愛知県
村井 寿明	murai_toshiaki@example.com	埼玉県
綾瀬 紗季	ayase_saki@example.com	大阪府
高山 はるみ	takayama_harumi@example.com	大阪府
浜口 たまき	hamaguchi_tamaki@example.com	東京都
妹尾 まなみ	seo_manami@example.com	青森県
三浦 法子	miura_noriko@example.com	群馬県
川畑 ひろみ	kawahata_hiromi@example.com	奈良県
森永 長利	morinaga_nagatoshi@example.com	大阪府
雨宮 玲那	amamiya_rena@example.com	北海道
古谷 晃司	furutani_kouji@example.com	福井県
川辺 守	kawabe_mamoru@example.com	愛媛県
岡田 さやか	okada_sayaka@example.com	埼玉県
山本 華子	yamamoto_hanako@example.com	福岡県
藤原 かおり	fujiwara_kaori@example.com	埼玉県
一木 憲史	ichiki_norihito@example.com	新潟県
とよた なつみ	toyota_natsumi@example.com	熊本県
松浦 詩織	matsuura_shiori@example.com	福岡県
竹原 隆之介	takehara_ryuunosuke@example.com	北海道
吉永 真一	yoshinaga_shinichi@example.com	茨城県
熊谷 早織	kumagaya_saori@example.com	東京都
渡部 薫	watabe_kaoru@example.com	岐阜県
神田 恵美	kannda_megumi@example.com	岐阜県
丸山 麻由子	maruyama_mayuko@example.com	青森県
横川 えみ	yokokawa_emi@example.com	栃木県
青木 美希	aoki_miki@example.com	埼玉県
田所 綾	tadokoro_aya@example.com	岐阜県
杉原 あさみ	sugihara_asami@example.com	東京都
有賀 耕司	ariga_kouji@example.com	北海道
玉城 ヒカル	tamaki_hikaru@example.com	大阪府
本村 優一	honnmura_yuuichi@example.com	大阪府
松居 奈々	matsui_nana@example.com	香川県
岡島 寿明	okajima_toshiaki@example.com	佐賀県
市原 七世	ichihara_nanase@example.com	神奈川県
矢作 豊	yahagi_yutaka@example.com	埼玉県
榊原 照生	sakakibara_teruo@example.com	宮城県
笹川 麻緒	sasagawa_mao@example.com	熊本県
山根 麗奈	yamane_rena@example.com	愛媛県
宮地 憲一	miyaji_kenichi@example.com	長崎県
安田 優	yasuda_yuu@example.com	広島県
小林 惇	kobayashi_atsushi@example.com	長崎県
井上 なつみ	inoue_natsumi@example.com	埼玉県
秦 英嗣	hata_hidetsugu@example.com	宮崎県
岡村 美希	okamura_miki@example.com	栃木県
河内 フミヤ	kawauchi_fumiya@example.com	広島県
永島 染五郎	nagashima_somegorou@example.com	東京都
田代 克実	tashiro_katsumi@example.com	広島県
美輪 碧海	miwa_ouga@example.com	愛知県
萩原 麗奈	hagiwara_rena@example.com	大阪府
木下 里奈	kinoshita_rina@example.com	愛知県
甲斐 晋也	kai_shinya@example.com	東京都
松居 茜	matsui_akane@example.com	愛媛県
北沢 研二	kitazawa_kenji@example.com	栃木県
高樹 充則	takagi_mitsunori@example.com	福岡県
仲村 淳	nakamura_atsushi@example.com	埼玉県
下川 まさみ	shimokawa_masami@example.com	愛知県
玉城 詩織	tamaki_shiori@example.com	大阪府
畠山 明日	hatayama_meibi@example.com	北海道
中川 真奈美	nakagawa_manami@example.com	兵庫県
畠中 慎之介	hatanaka_shinnosuke@example.com	神奈川県
若山 恵梨香	wakayama_erika@example.com	京都府
中西 メイサ	nakanishi_meisa@example.com	東京都
大庭 ちえみ	ooniwa_chiemi@example.com	佐賀県
松下 麻由子	matsushita_mayuko@example.com	岐阜県
荻原 愛菜	hagiwara_aina@example.com	福島県
小山 サンタマリア	oyama_stmaria@example.com	静岡県
吹石 誠治	fukiishi_seiji@example.com	福井県
成海 美紀	narumi_miki@example.com	埼玉県
角田 茂樹	kadota_shigeki@example.com	山形県
坂東 雅彦	banntou_masahiko1@example.com	神奈川県
近藤 あき	kondou_aki@example.com	埼玉県
瀬尾 裕次郎	seo_yuujirou@example.com	愛知県
大地 美月	oochi_miduki@example.com	栃木県
越智 りえ	ochi_rie@example.com	佐賀県
浜口 一樹	hamaguchi_kazuki@example.com	大阪府
芳賀 勝久	haga_katsuhisa@example.com	大阪府
浅見 恵子	asami_keiko@example.com	新潟県
板倉 理紗	itakura_risa@example.com	群馬県
榎本 芳正	enomoto_yoshimasa@example.com	福島県
脇田 ジローラモ	wakita_girolamo@example.com	長野県
桑田 美月	kuwata_miduki@example.com	栃木県
大竹 紗季	ootake_saki@example.com	神奈川県
宮部 華子	miyabe_hanako@example.com	群馬県
河合 照生	kawai_teruo@example.com	神奈川県
坂下 勇一	sakashita_yuuichi@example.com	兵庫県
荻野 早紀	ogino_saki@example.com	東京都
高尾 なぎさ	takao_nagisa@example.com	東京都
大倉 マサカズ	ookura_masakazu@example.com	兵庫県
仲村 薫	nakamura_kaoru@example.com	東京都
三村 一恵	mimura_kadue@example.com	岡山県
小泉 真一	koizumi_shinichi@example.com	神奈川県
宇田川 米蔵	udagawa_yonezou@example.com	岐阜県
岡本 光	okamoto_hikaru@example.com	神奈川県
白鳥 璃子	shiratori_riko@example.com	東京都
車 晴臣	kuruma_haruomi@example.com	熊本県
立石 かおり	tachiishi_kaori@example.com	広島県
寺脇 桃子	terawaki_momoko@example.com	岩手県
久保田 雅之	kubota_masayuki@example.com	東京都
鹿島 菊生	kashima_kikuo@example.com	兵庫県
浜 芽以	hama_mei@example.com	岐阜県
小泉 慶二	koizumi_keiji@example.com	長野県
綾小路 みゆき	ayanokouji_miyuki@example.com	鹿児島県
三浦 恭子	miura_kyouko@example.com	福岡県
米沢 聡	yonezawa_satoshi@example.com	静岡県
植村 莉緒	uemura_rio@example.com	北海道
末永 陽子	suenaga_youko1@example.com	兵庫県
安部 豊	abe_yutaka@example.com	東京都
とよた 英嗣	toyota_hidetsugu@example.com	宮崎県
宮本 憲一	miyamoto_kenichi@example.com	徳島県
横川 鉄二	yokokawa_tetsuji@example.com	茨城県
谷村 美菜	tanimura_mina@example.com	神奈川県
鈴木 徹平	suzuki_teppei@example.com	滋賀県
香川 早紀	kagawa_saki@example.com	広島県
堀内 奈央	horiuchi_nao@example.com	岐阜県
杉浦 美紀	sugiura_miki@example.com	静岡県
西島 人志	nishijima_hitoshi@example.com	神奈川県
北村 雅功	kitamura_masatoshi@example.com	兵庫県
永島 竜次	nagashima_ryuuji@example.com	東京都
神戸 れいな	koube_reina@example.com	大阪府
山中 真帆	yamanaka_maho@example.com	香川県
柴田 恵美	shibata_megumi@example.com	東京都
大友 愛梨	ootomo_airi@example.com	静岡県
末永 さとみ	suenaga_satomi@example.com	千葉県
永島 杏	nagashima_ann@example.com	熊本県
有馬 雅彦	arima_masahiko@example.com	大阪府
広川 剛基	hirokawa_yoshiki@example.com	栃木県
宮原 秀樹	miyahara_hideki@example.com	神奈川県
近藤 なつみ	konndou_natsumi@example.com	鳥取県
三宅 あさみ	miyake_asami@example.com	兵庫県
西村 恵子	nishimura_keiko@example.com	栃木県
末永 弘也	suenaga_hironari@example.com	東京都
竹中 まさみ	takenaka_masami1@example.com	静岡県
村山 まさし	murayama_masashi@example.com	大阪府
小島 祐基	kojima_yuuki@example.com	東京都
一青 光良	hitoto_teruyoshi@example.com	福島県
工藤 礼子	kudou_reiko@example.com	三重県
大高 慎之介	oodaka_shinnosuke@example.com	熊本県
戸塚 美智子	toduka_michiko@example.com	東京都
奥貫 はるか	okunuki_haruka@example.com	山梨県
青山 瞬	aoyama_shun@example.com	東京都
立石 結子	tachiishi_yuuko@example.com	石川県
佐藤 文世	satou_fumiyo@example.com	北海道
松下 貴嶺	matsushita_takane@example.com	静岡県
橘 ケンイチ	tachibana_kenichi@example.com	青森県
瀬戸 六郎	seto_rokurou@example.com	埼玉県
角田 佳乃	kadota_yoshino@example.com	静岡県
高村 敦	takamura_atsushi@example.com	神奈川県
沖田 ひかり	okita_hikari@example.com	兵庫県
大場 あおい	ooba_aoi@example.com	愛知県
高山 なつみ	takayama_natsumi@example.com	山梨県
水川 聖陽	mizukawa_masaaki@example.com	三重県
岩沢 満	iwasawa_mitsuru@example.com	埼玉県
梅原 さやか	umehara_sayaka@example.com	群馬県
成海 薫	narumi_kaoru@example.com	福島県
三島 ヒロ	mishima_hiro@example.com	富山県
奥 サンタマリア	oku_stmaria@example.com	長崎県
手島 那奈	tejima_nana@example.com	長野県
村瀬 敏和	murase_toshikazu@example.com	福島県
小倉 大樹	ogura_hiroki@example.com	鹿児島県
藤川 あさみ	fujikawa_asami@example.com	宮崎県
さだ 敏也	sada_toshiya@example.com	埼玉県
丹野 花	tannno_hana@example.com	福岡県
内田 ヒロ	uchida_hiro@example.com	愛知県
田崎 扶樹	tazaki_motoki@example.com	静岡県
沢井 隆	sawai_takashi@example.com	大阪府
川原 晴臣	kawahara_haruomi@example.com	東京都
戸田 弘也	toda_hironari@example.com	愛知県
足立 希	adachi_nozomi@example.com	富山県
野崎 涼	nozaki_ryou@example.com	宮崎県
青木 龍吉	aoki_ryuukichi@example.com	東京都
梅本 菜々美	umemoto_nanami@example.com	北海道
狩野 薫	kano_kaoru@example.com	宮城県
八木 彩華	yagi_ayaka@example.com	兵庫県
浅野 美和子	asano_miwako@example.com	大阪府
畠中 克実	hatanaka_katsumi@example.com	愛知県
芦屋 菊生	ashiya_kikuo@example.com	大分県
神野 薫	kamino_kaoru@example.com	東京都
久米 惇	kume_atsushi@example.com	奈良県
高山 光臣	takayama_mitsuomi@example.com	東京都
児島 南朋	kojima_nao@example.com	愛知県
竹原 璃奈子	takehara_rinako@example.com	東京都
上原 雅彦	uehara_masahiko@example.com	静岡県
岸部 勇太	kishibe_yuuta@example.com	静岡県
細野 雅彦	hosono_masahiko@example.com	長野県
福島 美咲	fukushima_misaki@example.com	岡山県
山上 佳乃	yamagami_yoshino@example.com	愛知県
江川 礼子	egawa_reiko@example.com	神奈川県
高木 涼子	takagi_ryouko@example.com	福島県
若山 花	wakayama_hana@example.com	千葉県
手島 幸平	tejima_kouhei@example.com	宮城県
野口 那奈	noguchi_nana@example.com	栃木県
下田 沙知絵	shimoda_sachie@example.com	埼玉県
角田 晋也	kadota_shinya@example.com	千葉県
川瀬 恵美	kawase_megumi@example.com	千葉県
中岡 有起哉	nakaoka_yukiya@example.com	千葉県
今井 友也	imai_tomoya@example.com	東京都
立川 太朗	tachikawa_tarou@example.com	栃木県
古川 窈	furukawa_you@example.com	北海道
畑中 りえ	hatanaka_rie@example.com	栃木県
竹内 しぼり	takeuchi_shibori@example.com	奈良県
金城 璃奈子	kanashiro_rinako@example.com	東京都
土田 信吾	tsuchida_shingo@example.com	大分県
小柳 長利	koyanagi_nagatoshi@example.com	東京都
甲斐 右京	kai_ukyou@example.com	愛知県
松島 あおい	matsushima_aoi@example.com	岐阜県
北野 信吾	kitano_shingo@example.com	千葉県
根本 恵梨香	nemoto_erika@example.com	愛知県
河内 杏	kawauchi_ann@example.com	京都府
中野 璃子	nakano_riko@example.com	広島県
瀬戸 麻緒	seto_mao@example.com	京都府
紺野 菜摘	konno_natsumi@example.com	静岡県
国分 佳乃	kokubunn_yoshino@example.com	埼玉県
山上 恵梨香	yamagami_erika@example.com	広島県
長田 雅之	nagata_masayuki@example.com	埼玉県
神谷 佑	kamiya_tasuku@example.com	栃木県
山田 瑠璃亜	yamada_ruria@example.com	東京都
吉本 聡	yoshimoto_satoshi@example.com	宮崎県
生田 知世	namata_chise@example.com	長野県
千田 ひろ子	sennda_hiroko@example.com	新潟県
森下 那奈	morishita_nana@example.com	京都府
寺本 竜次	teramoto_ryuuji@example.com	大分県
大木 右京	ooki_ukyou@example.com	静岡県
諏訪 ヒカル	suwa_hikaru@example.com	兵庫県
矢作 華子	yahagi_hanako@example.com	東京都
宮崎 薫	miyazaki_kaoru@example.com	埼玉県
井出 そら	ide_sora@example.com	千葉県
本村 桃子	honnmura_momoko@example.com	三重県
川越 妃里	kawagoe_yuri@example.com	京都府
矢田 涼	yada_ryou@example.com	愛知県
児玉 貴嶺	kodama_takane@example.com	栃木県
富樫 麻緒	togashi_mao@example.com	新潟県
武内 博明	takeuchi_hiroaki@example.com	神奈川県
柳家 コウ	yanagiya_kou@example.com	福岡県
瀬戸 なぎさ	seto_nagisa@example.com	愛知県
宇佐美 精児	usami_seiji@example.com	福島県
山城 豊	yamashiro_yutaka@example.com	愛媛県
相川 奈央	aikawa_nao@example.com	沖縄県
吉永 完爾	yoshinaga_kanji@example.com	富山県
岸 誠一	kishi_seiichi@example.com	千葉県
江藤 由美子	etou_yumiko@example.com	神奈川県
柳 憲史	yanagi_norihito@example.com	神奈川県
大平 徹平	oohira_teppei@example.com	千葉県
青木 ケンイチ	aoki_kenichi@example.com	神奈川県
鹿賀 さとみ	kaga_satomi@example.com	千葉県
大沢 祐基	oosawa_yuuki@example.com	大阪府
真田 コウ	sanada_kou@example.com	福島県
邑野 丈雄	murano_takeo@example.com	宮城県
青木 怜奈	aoki_reina1@example.com	三重県
稲葉 芳正	inaba_yoshimasa@example.com	千葉県
鶴田 薫	tsuruta_kaoru@example.com	広島県
三田 努	mita_tsutomu@example.com	山口県
藤澤 惇	fujisawa_jun@example.com	神奈川県
池上 完爾	ikegami_kanji@example.com	宮城県
神崎 あおい	kanzaki_aoi@example.com	愛知県
林田 さやか	hayashida_sayaka@example.com	熊本県
大林 達士	oobayashi_tatsuhito@example.com	山口県
深井 惇	fukai_atsushi@example.com	兵庫県
釈 鉄洋	shaku_tetsuhiro@example.com	神奈川県
阿久津 春樹	akutsu_haruki@example.com	福岡県
田口 寛	taguchi_hiroshi@example.com	神奈川県
大内 未來	oouchi_mirai@example.com	大阪府
大倉 窈	ookura_you@example.com	長崎県
江口 和久	eguchi_kazuhisa@example.com	三重県
稲田 美月	inada_miduki@example.com	佐賀県
玉木 南朋	tamaki_nao@example.com	埼玉県
菅谷 えみ	sugaya_emi@example.com	埼玉県
大路 勇	ooji_yuu@example.com	福岡県
深沢 一樹	fukazawa_kazuki@example.com	沖縄県
鬼頭 美智子	kitou_michiko@example.com	東京都
市川 真帆	ichikawa_maho@example.com	富山県
吉野 丈雄	yoshino_takeo@example.com	佐賀県
五大 祐一	godai_yuuichi@example.com	福井県
木内 ケンイチ	kiuchi_kenichi@example.com	神奈川県
溝口 小雁	mizoguchi_kogan@example.com	宮崎県
本多 哲平	honnda_teppei@example.com	神奈川県
寺田 大五郎	terada_daigorou@example.com	神奈川県
長友 太朗	nagatomo_tarou@example.com	神奈川県
大橋 広之	oohashi_hiroyuki@example.com	茨城県
塩田 春樹	shiota_haruki@example.com	大阪府
松原 雅彦	matsubara_masahiko@example.com	東京都
亀山 慢太郎	kameyama_mantarou@example.com	大阪府
首藤 美菜	sudou_mina@example.com	大阪府
南部 竜也	nannbu_tatsuya@example.com	青森県
彼方 惇	kanata_atsushi@example.com	東京都
毛利 裕司	mouri_yuuji@example.com	千葉県
ともさか 隼士	tomosaka_shunji1@example.com	徳島県
松下 明宏	matsushita_akihiro@example.com	大阪府
松原 里奈	matsubara_rina@example.com	秋田県
溝口 由美子	mizoguchi_yumiko@example.com	和歌山県
畑 優	hatake_yuu@example.com	静岡県
浅見 右京	asami_ukyou@example.com	大阪府
戸塚 大樹	toduka_hiroki@example.com	東京都
川上 美希	kawakami_miki@example.com	神奈川県
片瀬 光博	katase_mitsuhiro@example.com	東京都
入江 功補	irie_kousuke@example.com	福岡県
小栗 洋介	oguri_yousuke@example.com	鹿児島県
関 芳正	seki_yoshimasa@example.com	愛知県
比嘉 小雁	hiyoshi_kogan@example.com	北海道
長浜 美和子	nagahama_miwako@example.com	静岡県
岩村 聡	iwamura_satoshi@example.com	熊本県
星野 結子	hoshino_yuuko@example.com	富山県
村井 南朋	murai_nao@example.com	東京都
米沢 菜々美	yonezawa_nanami@example.com	山形県
森川 南朋	morikawa_nao@example.com	東京都
井川 めぐみ	igawa_megumi1@example.com	栃木県
杉山 祐基	sugiyama_yuuki@example.com	青森県
安部 隆	abe_takashi@example.com	大阪府
藤沢 勝久	fujisawa_katsuhisa@example.com	兵庫県
井川 綾	igawa_aya@example.com	神奈川県
西岡 美紀	nishioka_miki@example.com	山形県
亀山 昌代	kameyama_masayo@example.com	大阪府
宮迫 敏和	miyasako_toshikazu@example.com	愛知県
玉城 愛子	tamaki_aiko@example.com	愛知県
平沢 礼子	hirasawa_reiko@example.com	埼玉県
秋山 優一	akiyama_yuuichi@example.com	静岡県
竹下 小雁	takeshita_kogan@example.com	広島県
羽田 美紀	hata_miki@example.com	三重県
伴 明	ban_akira@example.com	滋賀県
山形 さとみ	yamagata_satomi@example.com	愛知県
益田 瞬	masuda_shun@example.com	神奈川県
菅原 みあ	sugawara_mia@example.com	長野県
富樫 璃奈子	togashi_rinako@example.com	北海道
柳原 徹平	yanagihara_teppei@example.com	長野県
井口 蒼甫	iguchi_sousuke@example.com	千葉県
三上 くるみ	mikami_kurumi@example.com	愛知県
柴崎 賢二	shibazaki_kenji@example.com	大阪府
佐川 勇介	sagawa_yuusuke@example.com	大阪府
井原 ひとり	ihara_hitori@example.com	和歌山県
三田 麻緒	mita_mao@example.com	石川県
白川 広司	shirakawa_kouji@example.com	長崎県
山城 秀樹	yamashiro_hideki@example.com	埼玉県
宇多田 花	utada_hana@example.com	千葉県
吉本 早織	yoshimoto_saori@example.com	神奈川県
上村 美幸	uemura_miyuki@example.com	沖縄県
とよた そら	toyota_sora@example.com	東京都
北条 雅之	houjou_masayuki@example.com	長野県
田辺 敏和	tanabe_toshikazu@example.com	沖縄県
金井 恵梨香	kanai_erika@example.com	大阪府
松永 愛子	matsunaga_aiko@example.com	鳥取県
高畑 優	takahata_yuu@example.com	愛媛県
豊島 翔	toyoshima_shou@example.com	兵庫県
向井 そら	murai_sora@example.com	徳島県
野際 薫	nogiwa_kaoru@example.com	兵庫県
宮崎 友以乃	miyazaki_yuino@example.com	鹿児島県
瀬戸内 基祐	setouchi_kisuke@example.com	東京都
岸部 将也	kishibe_masaya@example.com	東京都
片桐 遥	katagiri_haruka@example.com	埼玉県
竹中 しほり	takenaka_shihori@example.com	千葉県
赤羽 雅之	akabane_masayuki@example.com	和歌山県
ほしの 米蔵	hoshino_yonezou@example.com	広島県
坂下 知史	sakashita_tomofumi@example.com	栃木県
大坂 陽子	oosaka_youko@example.com	兵庫県
遠山 花緑	tooyama_karoku@example.com	青森県
役所 浩太郎	yakusho_koutarou@example.com	福岡県
富岡 美佳	tomioka_mika@example.com	沖縄県
尾崎 直人	ozaki_naoto@example.com	徳島県
安藤 夏希	ando_natsuki@example.com	千葉県
高木 ひかり	takagi_hikari@example.com	岡山県
秋本 直人	akimoto_naoto@example.com	埼玉県
本多 裕次郎	honnda_yuujirou@example.com	長野県
花田 六郎	hanada_rokurou@example.com	群馬県
土橋 杏	tsuchihashi_ann@example.com	神奈川県
尾崎 健	ozaki_ken@example.com	岩手県
浜野 弘也	hamano_hironari@example.com	茨城県
長沢 妃里	nagasawa_yuri@example.com	香川県
牧 勝久	maki_katsuhisa@example.com	福岡県
玉木 玲那	tamaki_rena@example.com	東京都
市原 浩太郎	ichihara_koutarou@example.com	富山県
塚原 獅童	tsukahara_shidou@example.com	富山県
城咲 法嗣	shirosaki_houshi@example.com	東京都
滝本 しぼり	takimoto_shibori@example.com	静岡県
相原 秀樹	aihara_hideki@example.com	大阪府
曽根 ヒカル	sone_hikaru@example.com	静岡県
小川 花	ogawa_hana@example.com	栃木県
中園 恵望子	nakazono_emiko@example.com	石川県
北原 真一	kitahara_shinichi@example.com	宮崎県
大沢 奈々	oosawa_nana@example.com	宮城県
唐沢 花	karasawa_hana@example.com	神奈川県
坂本 満	sakamoto_mitsuru@example.com	千葉県
佐竹 コウ	satake_kou@example.com	愛知県
須田 ケンイチ	suda_kenichi@example.com	埼玉県
金丸 米蔵	kanamaru_yonezou@example.com	愛知県
永野 優	nagano_yuu@example.com	茨城県
浅井 まさみ	asai_masami@example.com	青森県
水田 まさし	mizuta_masashi@example.com	栃木県
梶原 優	kajiwara_yuu@example.com	千葉県
川瀬 まひる	kawase_mahiru@example.com	三重県
神谷 敦	kamiya_atsushi@example.com	神奈川県
福永 春樹	fukunaga_haruki@example.com	愛知県
山田 裕司	yamada_yuuji@example.com	埼玉県
片瀬 智花	katase_tomoka@example.com	兵庫県
大平 みゆき	oohira_miyuki@example.com	宮崎県
榎本 禄郎	enomoto_rokurou@example.com	東京都
照井 愛梨	terui_airi@example.com	愛知県
大平 花緑	oohira_karoku@example.com	大阪府
高見 瞳	takami_hitomi@example.com	栃木県
小林 路子	kobayashi_michiko@example.com	山梨県
小泉 一	koizumi_hajime@example.com	東京都
小西 一代	konishi_kazuyo@example.com	宮城県
山下 陽介	yamashita_yousuke@example.com	愛知県
黒岩 まさみ	kuroiwa_masami@example.com	山口県
磯部 雅彦	isobe_masahiko@example.com	京都府
津川 希	tsugawa_nozomi@example.com	山口県
飯野 綾女	iino_ayame@example.com	島根県
寺西 たまき	teranishi_tamaki@example.com	秋田県
早川 沙耶	hayakawa_saya@example.com	愛知県
西脇 洋介	nishiwaki_yousuke@example.com	埼玉県
井出 まみ	ide_mami@example.com	千葉県
植村 早紀	uemura_saki@example.com	愛知県
湊 翔子	minato_shouko@example.com	千葉県
津田 菜々美	tsuda_nanami@example.com	福岡県
富岡 哲平	tomioka_teppei@example.com	埼玉県
綾小路 佑	ayanokouji_tasuku@example.com	千葉県
篠山 勇介	shinoyama_yuusuke@example.com	東京都
秦 太朗	hata_tarou@example.com	山形県
鳥居 一代	torii_kazuyo@example.com	東京都
氏家 莉緒	ujiie_rio@example.com	栃木県
杉野 仁晶	sugino_hiroaki@example.com	富山県
富永 沙耶	tominaga_saya@example.com	山形県
仲村 一哉	nakamura_kazuya@example.com	埼玉県
芦田 美希	ashida_miki@example.com	愛知県
平田 真帆	hirata_maho@example.com	長野県
江藤 徹平	etou_teppei@example.com	神奈川県
神崎 信吾	kannzaki_shingo@example.com	愛知県
西尾 あさみ	nishio_asami@example.com	茨城県
小田島 恵梨香	odajima_erika@example.com	愛知県
並木 はるか	namiki_haruka@example.com	千葉県
松山 菜々美	matsuyama_nanami@example.com	愛媛県
岩下 涼	iwashita_ryou@example.com	長崎県
大浦 りえ	ooura_rie@example.com	岡山県
坂井 惇	sakai_jun@example.com	東京都
安倍 仁晶	abe_hiroaki@example.com	愛知県
益岡 景子	masuoka_keiko@example.com	福井県
手塚 妃里	teduka_yuri@example.com	東京都
尾崎 一徳	ozaki_ittoku@example.com	東京都
安座間 礼子	azama_reiko@example.com	岡山県
細野 慢太郎	hosono_mantarou@example.com	京都府
川島 友香	kawashima_tomoka@example.com	埼玉県
鹿賀 遥	kaga_haruka@example.com	宮城県
原田 淳	harada_atsushi@example.com	兵庫県
古川 里奈	furukawa_rina@example.com	愛知県
岡野 くるみ	okano_kurumi@example.com	北海道
矢口 有起哉	yaguchi_yukiya@example.com	愛知県
村松 和香	muramatsu_waka@example.com	千葉県
岩井 知世	iwai_chise@example.com	兵庫県
三宅 惇	miyake_jun@example.com	東京都
沢田 裕司	sawada_yuuji@example.com	奈良県
高田 誠治	takada_seiji@example.com	東京都
水嶋 秀樹	mizushima_hideki@example.com	神奈川県
飯田 茜	iida_akane@example.com	新潟県
菅野 華子	sugano_hanako@example.com	群馬県
井上 優	inoue_yuu@example.com	神奈川県
高原 育子	takahara_ikuko@example.com	岐阜県
及川 利夫	oikawa_toshio@example.com	千葉県
大川 将也	ookawa_masaya@example.com	熊本県
島 晋也	shima_shinya@example.com	東京都
吉岡 麗奈	yoshioka_rena@example.com	秋田県
阪本 まひる	sakamoto_mahiru@example.com	秋田県
細田 恭子	hosoda_kyouko@example.com	石川県
木本 法子	kimoto_noriko@example.com	宮崎県
武 聖陽	take_masaaki@example.com	神奈川県
関 貴嶺	seki_takane@example.com	兵庫県
井上 徹	inoue_tohru@example.com	静岡県
竹内 徹平	takeuchi_teppei@example.com	沖縄県
戸田 丈雄	toda_takeo@example.com	福岡県
小谷 知世	kotani_chise@example.com	兵庫県
江崎 由樹	ezaki_yuki@example.com	千葉県
河内 さとみ	kawauchi_satomi@example.com	大分県
江原 菜々美	ehara_nanami@example.com	東京都
芦屋 宏	ashiya_hiroshi@example.com	香川県
浅利 那奈	asari_nana@example.com	秋田県
宍戸 大五郎	shishido_daigorou@example.com	長野県
城田 寛	shirota_hiroshi@example.com	高知県
川辺 未來	kawabe_mirai@example.com	大阪府
上田 真希	ueda_maki@example.com	北海道
北山 京子	kitayama_kyouko@example.com	京都府
哀川 満	aikawa_mitsuru@example.com	栃木県
中園 陽子	nakazono_youko@example.com	東京都
田尻 莉緒	tajiri_rio@example.com	愛知県
真田 璃奈子	sanada_rinako@example.com	埼玉県
大河内 美和子	ookouchi_miwako@example.com	長崎県
野原 朝香	nohara_asaka@example.com	愛知県
芳賀 裕司	haga_yuuji@example.com	青森県
原 広司	hara_kouji@example.com	愛知県
安永 正敏	yasunaga_masatoshi@example.com	福島県
福山 光良	fukuyama_teruyoshi@example.com	静岡県
小川 誠一	ogawa_seiichi@example.com	神奈川県
野原 一恵	nohara_kadue@example.com	埼玉県
百瀬 竜次	momose_ryuuji@example.com	東京都
滝 さゆり	taki_sayuri@example.com	愛知県
三村 はるみ	mimura_harumi@example.com	長野県
立川 慶二	tachikawa_keiji@example.com	埼玉県
丹羽 徹平	tannba_teppei@example.com	神奈川県
長崎 康文	nagasaki_yasufumi@example.com	埼玉県
比嘉 千佳子	hiyoshi_chikako@example.com	兵庫県
竹村 雅之	takemura_masayuki@example.com	愛知県
生田 広之	namata_hiroyuki@example.com	福岡県
寺尾 隆	terao_takashi@example.com	東京都
綾瀬 友香	ayase_tomoka@example.com	佐賀県
安斎 しぼり	annzai_shibori@example.com	鹿児島県
山崎 充則	yamazaki_mitsunori@example.com	埼玉県
永山 桃子	nagayama_momoko@example.com	大阪府
朝倉 亮	asakura_ryou@example.com	兵庫県
石川 剛基	ishikawa_yoshiki@example.com	静岡県
竹内 洋介	takeuchi_yousuke@example.com	熊本県
小野 花緑	ono_karoku@example.com	東京都
井口 美咲	iguchi_misaki@example.com	北海道
池内 太朗	ikeuchi_tarou@example.com	埼玉県
中野 知世	nakano_chise@example.com	神奈川県
北野 一哉	kitano_kazuya@example.com	石川県
松本 洋介	matsumoto_yousuke@example.com	滋賀県
上野 和香	ueno_waka@example.com	神奈川県
高樹 郁恵	takagi_ikue@example.com	神奈川県
田口 光	taguchi_hikaru@example.com	福岡県
宮下 優一	miyashita_yuuichi@example.com	香川県
杉原 ノブヒコ	sugihara_nobuhiko@example.com	広島県
戎 弘也	ebisu_hironari@example.com	大阪府
滝沢 基祐	takizawa_kisuke@example.com	静岡県
松澤 恵子	matsuzawa_keiko@example.com	千葉県
市村 ケンイチ	ichimura_kenichi@example.com	千葉県
浜 真一	hama_shinichi@example.com	千葉県
岩淵 了	iwabuchi_ryou@example.com	広島県
八木 さんま	yagi_sanma@example.com	長野県
伊崎 聡	isaki_satoshi@example.com	福井県
柏木 まひる	kashiwagi_mahiru@example.com	大阪府
原 きみまろ	hara_kimimaro@example.com	山形県
塩谷 窈	shiotani_you@example.com	佐賀県
渡部 敏也	watabe_toshiya@example.com	千葉県
植木 理紗	ueki_risa@example.com	神奈川県
桑田 竜也	kuwata_tatsuya@example.com	茨城県
北川 はるか	kitagawa_haruka@example.com	東京都
藤崎 芽以	fujisaki_mei@example.com	兵庫県
滝 知史	taki_tomofumi@example.com	山口県
小野 芳正	ono_yoshimasa@example.com	岡山県
蛍原 竜也	hotohara_tatsuya@example.com	北海道
北原 優一	kitahara_yuuichi@example.com	埼玉県
田口 しほり	taguchi_shihori1@example.com	東京都
長崎 路子	nagasaki_michiko@example.com	大阪府
竹本 ひろみ	takemoto_hiromi@example.com	神奈川県
海音寺 砂羽	kaionji_sawa@example.com	東京都
立川 真奈美	tachikawa_manami@example.com	群馬県
沖 玲那	oki_rena@example.com	大阪府
野沢 理紗	nozawa_risa@example.com	広島県
妹尾 康文	seo_yasufumi@example.com	静岡県
若槻 光博	wakatsuki_mitsuhiro@example.com	宮崎県
石沢 紗季	ishizawa_saki1@example.com	神奈川県
長谷部 奈央	hasebe_nao@example.com	北海道
瀬戸内 真奈美	setouchi_manami@example.com	京都府
野口 菊生	noguchi_kikuo@example.com	千葉県
春日 鉄二	kasuga_tetsuji@example.com	愛知県
筧 太朗	kakei_tarou@example.com	千葉県
水島 美佐子	mizushima_misako@example.com	茨城県
植松 コウ	uematsu_kou@example.com	愛知県
増田 獅童	masuda_shidou@example.com	兵庫県
宮田 栄一	miyata_eiichi@example.com	岐阜県
福井 光博	fukui_mitsuhiro@example.com	福岡県
福島 ひろ子	fukushima_hiroko@example.com	青森県
黒木 洋介	kuroki_yousuke@example.com	東京都
出口 恵子	deguchi_keiko@example.com	神奈川県
大坪 季衣	ootsubo_toshie@example.com	沖縄県
戸塚 夏希	toduka_natsuki@example.com	高知県
春日 翔子	kasuga_shouko@example.com	福岡県
丸山 華子	maruyama_hanako@example.com	福岡県
貫地谷 翔	kanjiya_shou@example.com	神奈川県
稲垣 しぼり	inagaki_shibori@example.com	島根県
中西 砂羽	nakanishi_sawa@example.com	大分県
篠崎 豊	shinozaki_yutaka@example.com	岩手県
黒谷 美智子	kurotani_michiko@example.com	埼玉県
浅野 芳正	asano_yoshimasa@example.com	山梨県
貫地谷 隼士	kanjiya_shunji@example.com	三重県
芦田 秀隆	ashida_hidetaka@example.com	静岡県
大後 照生	oogo_teruo@example.com	滋賀県
市田 まさみ	ichida_masami@example.com	神奈川県
亀山 慢太郎	kameyama_mantarou1@example.com	富山県
高島 美紀	takashima_miki@example.com	宮城県
伊沢 佳乃	izawa_yoshino@example.com	千葉県
古谷 真一	furutani_shinichi@example.com	栃木県
三原 雄太	mihara_yuuta@example.com	北海道
浜野 翔	hamano_shou@example.com	岩手県
安 米蔵	yasu_yonezou@example.com	千葉県
臼井 美佐	usui_misa@example.com	北海道
高山 はじめ	takayama_hajime@example.com	北海道
黒木 サンタマリア	kuroki_stmaria@example.com	奈良県
宮原 紗季	miyahara_saki@example.com	群馬県
吉永 彩華	yoshinaga_ayaka@example.com	北海道
滝 彩華	taki_ayaka@example.com	茨城県
金児 美佐	kaneko_misa@example.com	静岡県
照井 勇	terui_yuu@example.com	秋田県
益岡 信輔	masuoka_shinsuke@example.com	岐阜県
下田 惇	shimoda_jun@example.com	広島県
長瀬 祐一	nagase_yuuichi@example.com	京都府
七瀬 美月	nanase_miduki@example.com	神奈川県
成田 美幸	narita_miyuki@example.com	兵庫県
小林 秀樹	kobayashi_hideki@example.com	兵庫県
首藤 基祐	sudou_kisuke@example.com	大阪府
金谷 良介	kanaya_ryousuke@example.com	大阪府
宮里 佳乃	miyazato_yoshino@example.com	長野県
相沢 明	aizawa_akira@example.com	福島県
島本 なつみ	shimamoto_natsumi@example.com	新潟県
磯野 れいな	isono_reina@example.com	福井県
今井 亜希	imai_aki@example.com	栃木県
宮野 あさみ	miyano_asami@example.com	愛知県
小口 功補	oguchi_kousuke@example.com	千葉県
沼田 隼士	numata_shunji@example.com	広島県
真鍋 花緑	manabe_karoku@example.com	大阪府
堤 あい	tsutsumi_ai@example.com	佐賀県
岸本 剛基	kishimoto_yoshiki@example.com	北海道
古山 寛	furuyama_hiroshi@example.com	鹿児島県
中 みき	naka_miki@example.com	徳島県
窪塚 了	kuboduka_ryou@example.com	岡山県
馬場 南朋	baba_nao@example.com	長野県
相馬 さんま	aiba_sanma@example.com	富山県
松本 そら	matsumoto_sora@example.com	愛知県
小笠原 祐一	ogasawara_yuuichi@example.com	山口県
泉 結子	izumi_yuuko@example.com	佐賀県
内田 りえ	uchida_rie@example.com	福岡県
白木 剛基	shiraki_yoshiki@example.com	東京都
福沢 一樹	fukuzawa_kazuki@example.com	宮城県
奥野 雅彦	okuno_masahiko@example.com	福岡県
立花 サダヲ	tachibana_sadawo@example.com	長野県
片山 奈々	katayama_nana@example.com	広島県
小日向 郁恵	kohinata_ikue@example.com	福岡県
大江 花	ooe_hana@example.com	鹿児島県
森谷 健	moriya_ken@example.com	石川県
平岡 翔	hiraoka_shou@example.com	大阪府
西谷 功補	nishiya_kousuke@example.com	埼玉県
美木 綾女	miki_ayame@example.com	愛媛県
西本 サダヲ	nishimoto_sadawo@example.com	大阪府
松原 薫	matsubara_kaoru@example.com	沖縄県
山内 陽子	yamanouchi_youko@example.com	神奈川県
伊東 一輝	itou_kazuki@example.com	愛媛県
沢井 慎之介	sawai_shinnosuke@example.com	東京都
小西 ヒカル	konishi_hikaru@example.com	東京都
長島 康文	nagashima_yasufumi@example.com	新潟県
半田 菊生	hannda_kikuo@example.com	神奈川県
川本 彩華	kawamoto_ayaka@example.com	奈良県
宮脇 一	miyawaki_hajime@example.com	広島県
井川 奈央	igawa_nao@example.com	愛知県
富田 寿々花	tomita_suzuka@example.com	新潟県
本山 染五郎	honnyama_somegorou@example.com	鹿児島県
原 徹	hara_tohru@example.com	福島県
玉田 亮	tamada_ryou@example.com	兵庫県
森本 一哉	morimoto_kazuya@example.com	秋田県
田畑 千夏	tabata_chinatsu@example.com	東京都
浅沼 さとみ	asanuma_satomi@example.com	東京都
吉原 サンタマリア	yoshiwara_stmaria@example.com	福岡県
石原 夏希	ishihara_natsuki@example.com	和歌山県
秋葉 勤	akiba_tsutomu@example.com	大分県
綾瀬 美嘉	ayase_mika@example.com	神奈川県
内海 幸平	uchimi_kouhei@example.com	宮崎県
岡 恵子	oka_keiko@example.com	岐阜県
福島 徹平	fukushima_teppei@example.com	兵庫県
楠本 優	kusumoto_yuu@example.com	北海道
松居 染五郎	matsui_somegorou@example.com	兵庫県
根本 さとみ	nemoto_satomi@example.com	神奈川県
益田 美月	masuda_miduki@example.com	千葉県
大熊 夏空	ookuma_sora@example.com	三重県
神谷 雅功	kamiya_masatoshi@example.com	東京都
高田 窈	takada_you@example.com	東京都
磯野 豊	isono_yutaka@example.com	神奈川県
井田 あい	ida_ai@example.com	兵庫県
前田 はるみ	maeda_harumi@example.com	埼玉県
奥田 京子	okuda_kyouko@example.com	兵庫県
安斎 菜摘	annzai_natsumi@example.com	福岡県
寺脇 幸子	terawaki_sachiko@example.com	広島県
大井 里穂	ooi_riho@example.com	神奈川県
田沢 はるみ	tazawa_harumi@example.com	岡山県
金山 南朋	kanayama_nao@example.com	岐阜県
新村 めぐみ	niimura_megumi@example.com	東京都
村井 はじめ	murai_hajime@example.com	神奈川県
丹野 ひろ子	tannno_hiroko@example.com	神奈川県
中里 人志	nakazato_hitoshi@example.com	東京都
結城 祐基	yuuki_yuuki@example.com	広島県
浜田 克実	hamada_katsumi@example.com	茨城県
田崎 貴嶺	tazaki_takane@example.com	大阪府
中野 沙知絵	nakano_sachie@example.com	愛知県
鹿島 由宇	kashima_yuu@example.com	埼玉県
武藤 右京	mutou_ukyou@example.com	新潟県
安倍 竜次	abe_ryuuji@example.com	北海道
安倍 基祐	abe_kisuke@example.com	青森県
西秋 獅童	nishiaki_shidou@example.com	福島県
米倉 秀樹	yonekura_hideki@example.com	青森県
小倉 美優	ogura_myuu@example.com	茨城県
土橋 なつみ	tsuchihashi_natsumi@example.com	鹿児島県
三沢 恵梨香	misawa_erika@example.com	岐阜県
奥田 景子	okuda_keiko@example.com	神奈川県
古賀 健	koga_ken@example.com	長崎県
豊島 沙耶	toyoshima_saya@example.com	神奈川県
市田 広司	ichida_kouji@example.com	神奈川県
黒川 ひろみ	kurokawa_hiromi@example.com	兵庫県
高橋 さとみ	takahashi_satomi@example.com	大分県
森山 りえ	moriyama_rie@example.com	京都府
矢沢 瞳	yazawa_hitomi@example.com	群馬県
石本 エリカ	ishimoto_erika@example.com	大阪府
杉本 大	sugimoto_masaru@example.com	福島県
大城 達士	ooshiro_tatsuhito@example.com	愛媛県
三枝 仁晶	sannshi_hiroaki@example.com	岡山県
中沢 そら	nakazawa_sora@example.com	愛知県
小林 雅功	kobayashi_masatoshi@example.com	群馬県
吉井 誠治	yoshii_seiji@example.com	福岡県
大平 亮	oohira_ryou@example.com	京都府
大森 努	oomori_tsutomu@example.com	千葉県
柴咲 まみ	shibasaki_mami@example.com	大阪府
西谷 芽以	nishiya_mei@example.com	山梨県
木田 洋介	kida_yousuke@example.com	福島県
和田 紗季	wada_saki@example.com	埼玉県
市川 めぐみ	ichikawa_megumi@example.com	東京都
ほしの 郁恵	hoshino_ikue@example.com	長野県
小松 有海	komatsu_ami@example.com	長野県
島袋 憲一	shimabukuro_kenichi@example.com	静岡県
井川 優	igawa_yuu@example.com	神奈川県
大林 美優	oobayashi_myuu@example.com	埼玉県
栗田 樹里	kurita_juri@example.com	沖縄県
馬場 りえ	baba_rie@example.com	愛知県
石野 早紀	ishino_saki@example.com	新潟県
横川 孝太郎	yokokawa_koutarou@example.com	岡山県
渡辺 美菜	watanabe_mina@example.com	大阪府
波多野 翔子	hatano_shouko@example.com	東京都
松本 三省	matsumoto_sansei@example.com	福井県
小沢 知世	ozawa_chise@example.com	佐賀県
土居 真悠子	doi_mayuko@example.com	島根県
野上 信輔	nogami_shinsuke@example.com	大阪府
三宅 幸子	miyake_sachiko@example.com	愛知県
前川 丈雄	maekawa_takeo@example.com	愛知県
細井 直人	hosoi_naoto@example.com	岩手県
島崎 有海	shimazaki_ami@example.com	福島県
本上 大五郎	honjo_daigorou@example.com	兵庫県
須賀 徹	suga_tooru@example.com	和歌山県
柳家 あさみ	yanagiya_asami@example.com	茨城県
森田 美智子	morita_michiko@example.com	北海道
田中 誠治	tanaka_seiji@example.com	大阪府
森田 理紗	morita_risa@example.com	岐阜県
石本 たかお	ishimoto_takao@example.com	愛媛県
長崎 有海	nagasaki_ami@example.com	神奈川県
川辺 六郎	kawabe_rokurou@example.com	千葉県
国分 莉沙	kokubunn_risa@example.com	山形県
近藤 景子	kondou_keiko@example.com	東京都
香椎 美帆	kashii_miho@example.com	群馬県
車 鉄洋	kuruma_tetsuhiro@example.com	静岡県
藤本 勇	fujimoto_yuu@example.com	山口県
横田 美幸	yokota_miyuki@example.com	三重県
北山 真帆	kitayama_maho@example.com	熊本県
三好 あい	miyoshi_ai@example.com	埼玉県
新垣 精児	niigaki_seiji@example.com	東京都
酒井 信吾	sakai_shingo@example.com	千葉県
本山 あさみ	honnyama_asami@example.com	山口県
大平 だん吉	oohira_dankichi@example.com	山梨県
篠山 幸子	shinoyama_sachiko@example.com	静岡県
岩下 憲一	iwashita_kenichi@example.com	愛知県
川原 りえ	kawahara_rie@example.com	千葉県
真田 恵子	sanada_keiko@example.com	岩手県
真鍋 さやか	manabe_sayaka@example.com	愛知県
重田 花	shigeta_hana@example.com	福井県
梅本 美月	umemoto_miduki@example.com	大阪府
中塚 和之	nakaduka_kazuyuki@example.com	福岡県
浜田 洋介	hamada_yousuke@example.com	大阪府
広瀬 俊介	hirose_shunsuke@example.com	愛知県
川中 獅童	kawanaka_shidou@example.com	富山県
毛利 春樹	mouri_haruki@example.com	北海道
少路 一哉	shouji_kazuya@example.com	兵庫県
服部 賢二	hattori_kenji@example.com	群馬県
小関 夏希	kozeki_natsuki@example.com	茨城県
高島 サダヲ	takashima_sadawo@example.com	宮城県
小野 真悠子	ono_mayuko@example.com	神奈川県
富田 一恵	tomita_kadue@example.com	岡山県
海野 綾女	umino_ayame@example.com	愛知県
仲田 亮介	nakata_ryousuke@example.com	神奈川県
井川 雅之	igawa_masayuki@example.com	愛知県
児島 たまき	kojima_tamaki@example.com	北海道
塚本 竜次	tsukamoto_ryuuji@example.com	埼玉県
七瀬 ひろみ	nanase_hiromi@example.com	岡山県
三谷 秀樹	mitani_hideki@example.com	宮城県
堀北 和久	horikita_kazuhisa@example.com	徳島県
車 季衣	kuruma_toshie@example.com	愛媛県
小市 法嗣	koichi_houshi@example.com	千葉県
辻 里穂	tsuji_riho@example.com	岡山県
馬場 優一	baba_yuuichi@example.com	京都府
宮坂 麻緒	miyasaka_mao@example.com	埼玉県
石野 美優	ishino_myuu@example.com	北海道
有村 広司	arimura_kouji@example.com	神奈川県
高樹 みき	takagi_miki@example.com	愛知県
荻野 慢太郎	ogino_mantarou@example.com	山梨県
若林 拓郎	wakabayashi_takurou@example.com	埼玉県
浜本 圭	hamamoto_kei@example.com	沖縄県
板倉 南朋	itakura_nao@example.com	兵庫県
浅見 直人	asami_naoto@example.com	茨城県
三船 杏	mifune_ann@example.com	神奈川県
合田 ノブヒコ	aida_nobuhiko@example.com	愛知県
竹内 未來	takeuchi_mirai@example.com	神奈川県
堀越 耕司	horikoshi_kouji@example.com	埼玉県
杉浦 慢太郎	sugiura_mantarou@example.com	神奈川県
滝本 健	takimoto_ken@example.com	愛知県
大熊 了	ookuma_ryou@example.com	東京都
中園 佳乃	nakazono_yoshino@example.com	福井県
大谷 なぎさ	ootani_nagisa@example.com	北海道
大津 那奈	ootsu_nana@example.com	大阪府
中井 愛子	nakai_aiko@example.com	埼玉県
大内 結衣	oouchi_yui@example.com	和歌山県
石田 研二	ishida_kenji@example.com	神奈川県
滝川 有起哉	takigawa_yukiya@example.com	神奈川県
横尾 サダヲ	yokoo_sadawo@example.com	神奈川県
広田 蒼甫	hirota_sousuke@example.com	熊本県
沖田 砂羽	okita_sawa@example.com	東京都
杉浦 夏希	sugiura_natsuki@example.com	北海道
広川 美和子	hirokawa_miwako@example.com	千葉県
神谷 正敏	kamiya_masatoshi1@example.com	兵庫県
宮下 サンタマリア	miyashita_stmaria@example.com	大阪府
石倉 小雁	ishikura_kogan@example.com	神奈川県
守屋 和之	moriya_kazuyuki@example.com	神奈川県
金子 光博	kaneko_mitsuhiro@example.com	福岡県
島 涼	shima_ryou@example.com	東京都
中野 莉沙	nakano_risa@example.com	山形県
岡部 明	okabe_akira@example.com	北海道
安井 高史	yasui_takashi@example.com	京都府
福井 賢治	fukui_kenji@example.com	神奈川県
安座間 太朗	azama_tarou@example.com	長野県
沢田 みゆき	sawada_miyuki@example.com	神奈川県
岩井 由美子	iwai_yumiko@example.com	新潟県
西谷 美優	nishiya_myuu@example.com	三重県
小町 そら	komachi_sora@example.com	北海道
有賀 里穂	ariga_riho@example.com	群馬県
生瀬 大五郎	namase_daigorou@example.com	静岡県
有村 有海	arimura_ami@example.com	滋賀県
一青 広司	hitoto_kouji@example.com	宮城県
菅野 龍吉	sugano_ryuukichi@example.com	北海道
内村 文世	uchimura_fumiyo@example.com	岡山県
美木 小百合	miki_sayuri@example.com	大阪府
後藤 人志	gotou_hitoshi@example.com	大阪府
秋田 和香	akita_waka@example.com	岩手県
中川 扶樹	nakagawa_motoki@example.com	和歌山県
川辺 結子	kawabe_yuuko@example.com	福岡県
小倉 新太	ogura_arata@example.com	千葉県
松尾 優	matsuo_yuu@example.com	宮崎県
柳 恵子	yanagi_keiko@example.com	大阪府
宮沢 美咲	miyazawa_misaki@example.com	北海道
渡辺 崇史	watanabe_takashi@example.com	千葉県
八田 光	yatsuda_hikaru@example.com	北海道
平良 新太	hirara_arata@example.com	愛知県
神木 瑠璃亜	kamiki_ruria@example.com	大阪府
杉本 花	sugimoto_hana@example.com	山口県
菅谷 朝陽	sugaya_asahi@example.com	東京都
熊井 佑	kumai_tasuku@example.com	長崎県
牧田 倫子	makita_noriko@example.com	熊本県
塩谷 薫	shiotani_kaoru@example.com	茨城県
中川 慶太	nakagawa_keita@example.com	茨城県
柴田 里穂	shibata_riho@example.com	福岡県
小室 亮	komuro_ryou@example.com	静岡県
若杉 なつみ	wakasugi_natsumi@example.com	奈良県
山野 三省	yamano_sansei@example.com	岐阜県
松山 ヒカル	matsuyama_hikaru@example.com	千葉県
西野 愛菜	nishino_aina@example.com	埼玉県
片桐 浩太郎	katagiri_koutarou@example.com	福岡県
安藤 まさし	ando_masashi@example.com	埼玉県
布施 右京	fuse_ukyou@example.com	東京都
山根 真帆	yamane_maho@example.com	兵庫県
村井 美佳	murai_mika@example.com	香川県
新垣 隆之介	niigaki_ryuunosuke@example.com	愛媛県
角田 美月	kadota_miduki@example.com	栃木県
白鳥 茜	shiratori_akane@example.com	埼玉県
花岡 優一	hanaoka_yuuichi@example.com	京都府
渡部 光良	watabe_teruyoshi@example.com	福岡県
平沢 春樹	hirasawa_haruki@example.com	山形県
岡山 かおり	okayama_kaori@example.com	滋賀県
正木 祐一	masaki_yuuichi@example.com	茨城県
林 広之	hayashi_hiroyuki@example.com	神奈川県
小杉 詩織	kosugi_shiori@example.com	宮城県
中塚 雅彦	nakaduka_masahiko@example.com	山口県
松木 朝陽	matsuki_asahi@example.com	山形県
藤木 慶太	fujiki_keita@example.com	埼玉県
西尾 由美子	nishio_yumiko@example.com	広島県
石橋 精児	ishibashi_seiji1@example.com	神奈川県
宇都宮 圭	utsunomiya_kei@example.com	岡山県
堀田 鉄二	hotta_tetsuji@example.com	宮城県
木内 明宏	kiuchi_akihiro@example.com	愛知県
鈴木 隆之介	suzuki_ryuunosuke@example.com	神奈川県
黄川田 幸平	kikawada_kouhei@example.com	神奈川県
河内 勇一	kawauchi_yuuichi@example.com	群馬県
唐沢 莉沙	karasawa_risa@example.com	新潟県
高沢 一恵	takasawa_kadue@example.com	大阪府
池田 希	ikeda_nozomi@example.com	愛知県
桑田 そら	kuwata_sora@example.com	岐阜県
大倉 博明	ookura_hiroaki@example.com	兵庫県
宮迫 瑠璃亜	miyasako_ruria@example.com	大阪府
羽田 直人	hada_naoto@example.com	埼玉県
長浜 英嗣	nagahama_hidetsugu@example.com	北海道
菅原 マサカズ	sugawara_masakazu@example.com	東京都
菅井 菜々美	sugai_nanami@example.com	長野県
小日向 照生	kohinata_teruo@example.com	静岡県
志村 寛	shimura_hiroshi@example.com	広島県
本橋 将也	motohashi_masaya@example.com	石川県
松澤 勇介	matsuzawa_yuusuke@example.com	東京都
及川 愛菜	oikawa_aina@example.com	石川県
臼井 徹	usui_tooru@example.com	滋賀県
菅野 正義	sugano_masayoshi@example.com	東京都
馬場 恵麻	baba_ema@example.com	神奈川県
谷 勝久	tani_katsuhisa@example.com	佐賀県
平 礼子	taira_reiko@example.com	東京都
寺田 佑	terada_tasuku@example.com	東京都
水野 豊	mizuno_yutaka@example.com	宮崎県
毛利 剛基	mouri_yoshiki@example.com	兵庫県
小松 玲那	komatsu_rena@example.com	熊本県
岡本 健	okamoto_ken@example.com	千葉県
相馬 奈々	aiba_nana@example.com	愛知県
赤松 悟志	akamatsu_satoshi@example.com	新潟県
福永 雅之	fukunaga_masayuki@example.com	長崎県
坂本 一樹	sakamoto_kazuki@example.com	神奈川県
長野 染五郎	nagano_somegorou@example.com	新潟県
土橋 明宏	tsuchihashi_akihiro@example.com	愛知県
松澤 ひかり	matsuzawa_hikari@example.com	静岡県
岩下 丈雄	iwashita_takeo@example.com	兵庫県
奥 まさし	oku_masashi@example.com	静岡県
北原 米蔵	kitahara_yonezou@example.com	兵庫県
土居 美佐子	doi_misako@example.com	新潟県
丹野 璃子	tannno_riko@example.com	福島県
瀬戸内 満	setouchi_mitsuru@example.com	滋賀県
唐沢 剛基	karasawa_yoshiki@example.com	新潟県
吉田 サダヲ	yoshida_sadawo@example.com	福岡県
矢部 雄太	yabe_yuuta@example.com	高知県
吉川 満	yoshikawa_mitsuru@example.com	新潟県
奥村 里奈	okumura_rina@example.com	愛媛県
吉沢 信吾	yoshizawa_shingo@example.com	福島県
小関 めぐみ	kozeki_megumi@example.com	千葉県
小室 了	komuro_ryou1@example.com	山形県
金井 貴美子	kanai_kimiko@example.com	千葉県
田村 勇	tamura_yuu@example.com	和歌山県
三沢 慶太	misawa_keita@example.com	宮城県
畑 麻由子	hatake_mayuko@example.com	北海道
中園 ジョージ	nakazono_george@example.com	神奈川県
広末 光博	hirosue_mitsuhiro@example.com	埼玉県
橋口 季衣	hashiguchi_toshie@example.com	北海道
谷川 杏	tanikawa_ann@example.com	山形県
佐野 春樹	sano_haruki@example.com	北海道
笹原 俊介	sasahara_shunsuke@example.com	千葉県
根本 美幸	nemoto_miyuki@example.com	千葉県
藤島 美佐子	fujishima_misako@example.com	大阪府
大浦 昌代	ooura_masayo@example.com	茨城県
島田 美咲	shimada_misaki@example.com	静岡県
石野 勤	ishino_tsutomu@example.com	群馬県
若杉 茂樹	wakasugi_shigeki@example.com	神奈川県
河内 愛	kawauchi_ai@example.com	兵庫県
田中 小雁	tanaka_kogan@example.com	山形県
小椋 里穂	ogura_riho@example.com	北海道
木本 優	kimoto_yuu@example.com	愛媛県
東 育二	higashi_ikuji@example.com	岐阜県
石沢 あおい	ishizawa_aoi@example.com	兵庫県
田畑 浩介	tabata_kousuke@example.com	栃木県
松沢 真悠子	matsuzawa_mayuko@example.com	東京都
桜井 理紗	sakurai_risa@example.com	香川県
金井 あおい	kanai_aoi@example.com	埼玉県
鹿島 俊介	kashima_shunsuke@example.com	新潟県
長谷川 美嘉	hasegawa_mika@example.com	愛媛県
井原 孝太郎	ihara_koutarou@example.com	岡山県
武 完爾	take_kanji@example.com	山口県
橋口 未來	hashiguchi_mirai@example.com	大阪府
石丸 礼子	ishimaru_reiko@example.com	静岡県
宮崎 良介	miyazaki_ryousuke@example.com	東京都
葛山 ちえみ	katsurayama_chiemi@example.com	島根県
藤井 隼士	fujii_shunji@example.com	千葉県
丹羽 かおり	tannba_kaori@example.com	青森県
玉城 徹	tamaki_tooru@example.com	長野県
三浦 翔	miura_shou@example.com	宮城県
有賀 晋也	ariga_shinya@example.com	兵庫県
笠原 勇介	kasahara_yuusuke@example.com	長野県
伊集院 陽介	ijuuin_yousuke@example.com	広島県
小沼 恵子	konuma_keiko@example.com	愛知県
長谷 礼子	nagaya_reiko@example.com	鳥取県
海野 ヒロ	umino_hiro@example.com	兵庫県
青柳 信吾	aoyagi_shingo@example.com	北海道
中西 鉄二	nakanishi_tetsuji@example.com	神奈川県
大西 ケンイチ	oonishi_kenichi@example.com	東京都
相馬 めぐみ	aiba_megumi@example.com	東京都
磯部 翔	isobe_shou@example.com	愛知県
金谷 コウ	kanaya_kou@example.com	兵庫県
野原 しぼり	nohara_shibori@example.com	新潟県
白木 莉沙	shiraki_risa@example.com	大分県
千葉 秀隆	chiba_hidetaka@example.com	三重県
徳田 雅之	tokuta_masayuki@example.com	山形県
清田 まさし	kiyota_masashi@example.com	高知県
安倍 美紀	abe_miki@example.com	奈良県
川辺 璃奈子	kawabe_rinako@example.com	千葉県
小菅 浩太郎	kosuge_koutarou@example.com	栃木県
貫地谷 春樹	kanjiya_haruki@example.com	埼玉県
寺島 幸平	terashima_kouhei@example.com	愛媛県
田所 季衣	tadokoro_toshie@example.com	岡山県
平 由宇	taira_yuu@example.com	北海道
塚本 大樹	tsukamoto_hiroki@example.com	神奈川県
那須 圭	nasu_kei@example.com	宮崎県
細井 洋介	hosoi_yousuke@example.com	京都府
中山 大五郎	nakayama_daigorou@example.com	千葉県
大内 光臣	oouchi_mitsuomi@example.com	静岡県
相原 明宏	aihara_akihiro@example.com	福岡県
米沢 秀隆	yonezawa_hidetaka@example.com	東京都
植田 昴	ueta_subaru@example.com	長崎県
平川 禄郎	hirakawa_rokurou@example.com	京都府
白石 遥	shiraishi_haruka@example.com	佐賀県
秋田 薫	akita_kaoru@example.com	東京都
とよた 雅彦	toyota_masahiko@example.com	埼玉県
芳賀 翔太	haga_shouta@example.com	神奈川県
山上 亮	yamagami_ryou@example.com	三重県
織田 昴	oda_subaru@example.com	新潟県
森下 三郎	morishita_saburou@example.com	栃木県
浜 竜次	hama_ryuuji@example.com	東京都
加藤 一哉	katou_kazuya@example.com	大阪府
五十嵐 研二	igarashi_kenji@example.com	香川県
大谷 ひろ子	ootani_hiroko@example.com	埼玉県
吉崎 洋介	yoshizaki_yousuke@example.com	千葉県
木戸 光良	kido_teruyoshi@example.com	福岡県
早川 広之	hayakawa_hiroyuki@example.com	愛知県
長岡 惇	nagaoka_jun@example.com	埼玉県
高岡 真悠子	takaoka_mayuko@example.com	秋田県
土屋 貴嶺	tsuchiya_takane@example.com	東京都
松谷 結衣	matsutani_yui@example.com	新潟県
品川 薫	shinagawa_kaoru@example.com	埼玉県
小畑 美和子	obata_miwako@example.com	岡山県
松田 一恵	matsuda_kadue@example.com	茨城県
城咲 小百合	shirosaki_sayuri@example.com	東京都
藤原 直人	fujiwara_naoto@example.com	岡山県
波多野 佳乃	hatano_yoshino@example.com	大阪府
滝本 勝久	takimoto_katsuhisa@example.com	新潟県
渡辺 豊	watanabe_yutaka@example.com	埼玉県
生田 勇	namata_yuu@example.com	神奈川県
樋口 慶太	higuchi_keita@example.com	神奈川県
根本 涼	nemoto_ryou@example.com	京都府
大川 知世	ookawa_chise@example.com	茨城県
鹿手袋 真一	shikatebukuro_shinichi@example.com	高知県
日比野 ひとり	hibino_hitori@example.com	鹿児島県
藤岡 愛梨	fujioka_airi@example.com	神奈川県
足立 英嗣	adachi_hidetsugu@example.com	山口県
奥野 優	okuno_yuu@example.com	愛知県
村山 蒼甫	murayama_sousuke@example.com	長崎県
亀山 和久	kameyama_kazuhisa@example.com	福岡県
青柳 友也	aoyagi_tomoya@example.com	京都府
山形 貴美子	yamagata_kimiko@example.com	愛知県
織田 美希	oda_miki@example.com	愛知県
片桐 一哉	katagiri_kazuya@example.com	北海道
磯野 ジョージ	isono_george@example.com	富山県
吉沢 光臣	yoshizawa_mitsuomi@example.com	茨城県
堤 亮	tsutsumi_ryou@example.com	長野県
熊谷 一輝	kumagaya_kazuki1@example.com	茨城県
岡田 綾	okada_aya@example.com	東京都
今川 ケンイチ	imagawa_kenichi@example.com	神奈川県
黒田 碧海	kurota_ouga@example.com	熊本県
榎本 由宇	enomoto_yuu@example.com	広島県
品川 璃奈子	shinagawa_rinako@example.com	長崎県
青野 鉄二	aono_tetsuji@example.com	新潟県
亀山 友以乃	kameyama_yuino@example.com	愛知県
秋山 景子	akiyama_keiko@example.com	愛知県
織田 一代	oda_kazuyo@example.com	神奈川県
矢田 雄太	yada_yuuta@example.com	福島県
栗山 佳乃	kuriyama_yoshino@example.com	千葉県
小柳 豊	koyanagi_yutaka@example.com	東京都
西島 彩	nishijima_aya@example.com	青森県
南部 菊生	nannbu_kikuo@example.com	栃木県
塩谷 染五郎	shiotani_somegorou@example.com	兵庫県
児玉 ジローラモ	kodama_girolamo@example.com	群馬県
早川 有海	hayakawa_ami@example.com	神奈川県
神崎 文世	kanzaki_fumiyo@example.com	兵庫県
松木 佳乃	matsuki_yoshino@example.com	埼玉県
豊島 まなみ	toyoshima_manami@example.com	東京都
大村 瑠璃亜	oomura_ruria@example.com	岐阜県
菅谷 美佳	sugaya_mika@example.com	山梨県
江川 さとみ	egawa_satomi@example.com	熊本県
鹿島 賢治	kashima_kenji@example.com	東京都
上条 かおり	kamijou_kaori@example.com	神奈川県
滝口 一恵	takiguchi_kadue@example.com	福岡県
小原 勇	ohara_yuu@example.com	兵庫県
水上 恵子	mizukami_keiko@example.com	大阪府
古屋 たまき	furuya_tamaki@example.com	大阪府
米谷 ケンイチ	yoneya_kenichi@example.com	神奈川県
石垣 南朋	ishigaki_nao@example.com	岩手県
岸田 紗季	kishida_saki@example.com	茨城県
田辺 愛梨	tanabe_airi@example.com	青森県
柏原 草太	kashiwara_souta@example.com	大分県
荒井 建	arai_ken@example.com	千葉県
寺尾 一哉	terao_kazuya@example.com	北海道
笹原 貴嶺	sasahara_takane@example.com	千葉県
岸 勇介	kishi_yuusuke@example.com	東京都
高沢 優	takasawa_yuu@example.com	東京都
植松 まなみ	uematsu_manami@example.com	福岡県
堀 みき	hori_miki@example.com	福岡県
金森 美佐	kanamori_misa@example.com	福岡県
伊崎 一哉	isaki_kazuya@example.com	秋田県
牧田 一徳	makita_ittoku@example.com	青森県
高倉 慶二	takakura_keiji@example.com	東京都
内田 玲那	uchida_rena@example.com	北海道
竹下 南朋	takeshita_nao@example.com	新潟県
梅原 洋	umehara_you@example.com	広島県
山崎 はるか	yamazaki_haruka@example.com	兵庫県
美木 なぎさ	miki_nagisa@example.com	広島県
影山 翔子	kageyama_shouko@example.com	兵庫県
浜崎 法嗣	hamasaki_houshi@example.com	東京都
角谷 陽子	kadotani_youko@example.com	神奈川県
西尾 聡	nishio_satoshi@example.com	埼玉県
小野田 しほり	onoda_shihori@example.com	福岡県
田崎 光博	tazaki_mitsuhiro@example.com	熊本県
藤森 まさみ	fujimori_masami@example.com	大阪府
戸田 勝久	toda_katsuhisa@example.com	大阪府
井川 大樹	igawa_hiroki@example.com	茨城県
木本 亜希	kimoto_aki@example.com	京都府
真田 結子	sanada_yuuko@example.com	埼玉県
平賀 さとみ	hiraga_satomi@example.com	宮崎県
藤村 友以乃	fujimura_yuino@example.com	大阪府
金山 真一	kanayama_shinichi@example.com	兵庫県
西原 ヒカル	nishihara_hikaru@example.com	埼玉県
蒼井 くるみ	aoi_kurumi@example.com	広島県
麻生 さとみ	asou_satomi@example.com	宮城県
上田 禄郎	ueda_rokurou@example.com	奈良県
井本 雄太	imoto_yuuta@example.com	兵庫県
妹尾 なつみ	seo_natsumi@example.com	宮城県
おかやま さんま	okayama_sanma@example.com	和歌山県
内野 雅彦	uchino_masahiko@example.com	千葉県
下田 博明	shimoda_hiroaki@example.com	岐阜県
矢野 涼子	yano_ryouko@example.com	静岡県
小田島 敦	odajima_atsushi@example.com	大阪府
杉下 ひろ子	sugishita_hiroko@example.com	神奈川県
石川 愛菜	ishikawa_aina@example.com	神奈川県
福田 はるみ	fukuda_harumi@example.com	神奈川県
畑中 信輔	hatanaka_shinsuke@example.com	福岡県
池谷 俊二	iketani_shunji@example.com	東京都
恩田 碧海	onnda_ouga@example.com	群馬県
小関 大樹	kozeki_hiroki@example.com	兵庫県
高梨 真吾	takanashi_shingo@example.com	東京都
水上 あさみ	mizukami_asami@example.com	東京都
小高 結子	kodaka_yuuko@example.com	北海道
堀川 直人	horikawa_naoto@example.com	京都府
水谷 希	mizutani_nozomi@example.com	茨城県
七瀬 憲一	nanase_kenichi@example.com	静岡県
藤崎 なぎさ	fujisaki_nagisa@example.com	埼玉県
木田 知世	kida_chise@example.com	長崎県
塩谷 芽以	shiotani_mei@example.com	富山県
柄本 勝久	emoto_katsuhisa@example.com	東京都
梶原 れいな	kajiwara_reina@example.com	石川県
新井 竜也	arai_tatsuya@example.com	福島県
桜田 仁	sakurada_jin@example.com	新潟県
古賀 広之	koga_hiroyuki@example.com	長野県
皆川 直人	minakawa_naoto@example.com	茨城県
松山 あい	matsuyama_ai@example.com	東京都
堀川 たまき	horikawa_tamaki@example.com	大阪府
坂本 千夏	sakamoto_chinatsu@example.com	奈良県
平尾 蒼甫	hirao_sousuke@example.com	山口県
長澤 智花	nagasawa_tomoka@example.com	兵庫県
三浦 由美子	miura_yumiko@example.com	埼玉県
桜井 みあ	sakurai_mia@example.com	福島県
米倉 季衣	yonekura_toshie@example.com	福岡県
角 朝香	sumi_asaka@example.com	岡山県
永井 美和子	nagai_miwako@example.com	神奈川県
宇多田 慎之介	utada_shinnosuke@example.com	京都府
安藤 樹里	anndou_juri@example.com	東京都
堀川 知世	horikawa_chise@example.com	福岡県
大谷 勝久	ootani_katsuhisa@example.com	茨城県
石坂 勝久	ishizaka_katsuhisa@example.com	東京都
佐々木 璃奈子	sasaki_rinako@example.com	沖縄県
緒方 まなみ	ogata_manami@example.com	東京都
島田 寛治	shimada_kanji@example.com	東京都
大和 一輝	yamato_kazuki@example.com	三重県
平 翔	taira_shou@example.com	岩手県
細川 育二	hosokawa_ikuji@example.com	神奈川県
坂元 薫	sakamoto_kaoru@example.com	宮崎県
戸田 さんま	toda_sanma@example.com	大阪府
下田 隼士	shimoda_shunji@example.com	神奈川県
平山 一哉	hirayama_kazuya@example.com	埼玉県
滝 広之	taki_hiroyuki@example.com	高知県
宮原 康文	miyahara_yasufumi@example.com	岡山県
前野 たかお	maeno_takao@example.com	京都府
小野寺 優	onodera_yuu@example.com	滋賀県
市村 輝信	ichimura_akinobu@example.com	福岡県
川崎 寿々花	kawasaki_suzuka@example.com	千葉県
平田 窈	hirata_you@example.com	茨城県
重松 桃子	shigematsu_momoko@example.com	神奈川県
内山 勇太	uchiyama_yuuta@example.com	東京都
宮島 華子	miyajima_hanako@example.com	広島県
沢田 信吾	sawada_shingo@example.com	宮崎県
津田 美紀	tsuda_miki@example.com	大阪府
熊沢 祐一	kumasawa_yuuichi@example.com	長野県
奥寺 怜奈	okudera_reina@example.com	埼玉県
有賀 明日	ariga_meibi@example.com	三重県
本多 恵梨香	honnda_erika@example.com	静岡県
相沢 しぼり	aizawa_shibori@example.com	神奈川県
城戸 裕次郎	kido_yuujirou@example.com	島根県
菅沼 友以乃	suganuma_yuino@example.com	神奈川県
中尾 茜	nakao_akane@example.com	東京都
大島 瑠璃亜	ooshima_ruria@example.com	兵庫県
細山 あさみ	hosoyama_asami@example.com	大阪府
小林 龍吉	kobayashi_ryuukichi@example.com	神奈川県
石川 さやか	ishikawa_sayaka@example.com	神奈川県
溝口 英嗣	mizoguchi_hidetsugu@example.com	大分県
柳原 達士	yanagihara_tatsuhito@example.com	愛知県
柴田 倫子	shibata_noriko@example.com	愛知県
小関 寿明	kozeki_toshiaki@example.com	埼玉県
田川 未來	tagawa_mirai@example.com	大阪府
西村 まさし	nishimura_masashi@example.com	栃木県
松沢 薫	matsuzawa_kaoru@example.com	東京都
堀内 瑠璃亜	horiuchi_ruria@example.com	滋賀県
佐伯 宏行	saeki_hiroyuki@example.com	東京都
山本 あさみ	yamamoto_asami@example.com	兵庫県
小室 孝太郎	komuro_koutarou@example.com	東京都
永山 雅彦	nagayama_masahiko@example.com	長崎県
熊井 愛菜	kumai_aina@example.com	東京都
坂田 美咲	sakata_misaki@example.com	島根県
松居 俊二	matsui_shunji@example.com	山形県
沢 翔子	sawa_shouko@example.com	北海道
酒井 夏希	sakai_natsuki@example.com	茨城県
下山 季衣	shimoyama_toshie@example.com	岩手県
桑原 聡	kuwabara_satoshi@example.com	大阪府
上野 小百合	ueno_sayuri@example.com	秋田県
岩淵 さゆり	iwabuchi_sayuri@example.com	和歌山県
溝口 奈央	mizoguchi_nao@example.com	兵庫県
有田 きみまろ	arita_kimimaro@example.com	東京都
平田 あさみ	hirata_asami@example.com	千葉県
宮地 一輝	miyaji_kazuki@example.com	福島県
平林 ひろみ	hirabayashi_hiromi@example.com	三重県
田辺 建	tanabe_ken1@example.com	千葉県
本田 たかお	honnda_takao@example.com	福島県
富田 涼	tomita_ryou@example.com	群馬県
谷川 みゆき	tanikawa_miyuki@example.com	秋田県
藤崎 幸平	fujisaki_kouhei@example.com	北海道
佐々木 弘也	sasaki_hironari@example.com	徳島県
浦野 明宏	urano_akihiro@example.com	北海道
岩田 佳乃	iwata_yoshino@example.com	千葉県
中村 くるみ	nakamura_kurumi@example.com	東京都
海野 惇	umino_atsushi@example.com	三重県
柄本 弘也	emoto_hironari@example.com	北海道
小島 さやか	kojima_sayaka@example.com	東京都
平野 丈雄	hirano_takeo@example.com	東京都
川本 れいな	kawamoto_reina@example.com	福島県
角 俊二	sumi_shunji@example.com	石川県
重田 知史	shigeta_tomofumi@example.com	和歌山県
三橋 明	mihashi_akira@example.com	秋田県
椎名 隆博	shiina_takahiro@example.com	香川県
佐藤 未華子	satou_mikako@example.com	島根県
石黒 雅彦	ishiguro_masahiko@example.com	埼玉県
三好 智花	miyoshi_tomoka@example.com	兵庫県
小沢 貴美子	ozawa_kimiko@example.com	北海道
小平 隆之介	kohira_ryuunosuke@example.com	兵庫県
高谷 詩織	takaya_shiori@example.com	鹿児島県
内田 一恵	uchida_kadue@example.com	新潟県
田所 基祐	tadokoro_kisuke@example.com	熊本県
大下 寛	ooshita_hiroshi@example.com	東京都
寺脇 彩	terawaki_aya@example.com	鳥取県
小川 ヒロ	ogawa_hiro1@example.com	京都府
神木 三郎	kamiki_saburou@example.com	神奈川県
荒木 一樹	araki_kazuki@example.com	神奈川県
中尾 めぐみ	nakao_megumi@example.com	東京都
石原 法嗣	ishihara_houshi@example.com	福岡県
平 千佳子	taira_chikako@example.com	青森県
富樫 雅之	togashi_masayuki@example.com	神奈川県
上山 まさみ	kamiyama_masami@example.com	神奈川県
土居 友也	doi_tomoya@example.com	千葉県
飯田 健	iida_ken@example.com	愛知県
梅本 那奈	umemoto_nana@example.com	山口県
井原 優	ihara_yuu@example.com	埼玉県
臼井 新太	usui_arata@example.com	和歌山県
青木 薫	aoki_kaoru1@example.com	青森県
西本 草太	nishimoto_souta@example.com	東京都
大下 美咲	ooshita_misaki@example.com	茨城県
河合 咲	kawai_saki@example.com	愛知県
川辺 由樹	kawabe_yuki@example.com	岩手県
滝口 ひとり	takiguchi_hitori@example.com	神奈川県
長瀬 優	nagase_yuu@example.com	埼玉県
豊島 徹	toyoshima_tohru@example.com	長崎県
向井 明日	murai_meibi@example.com	佐賀県
高柳 徹平	takayanagi_teppei@example.com	鳥取県
島田 芳正	shimada_yoshimasa@example.com	広島県
秦 豊	hata_yutaka@example.com	沖縄県
福岡 そら	fukuoka_sora@example.com	静岡県
喜多 蒼甫	kita_sousuke@example.com	兵庫県
和泉 だん吉	waizumi_dankichi@example.com	福島県
岡本 憲一	okamoto_kenichi@example.com	高知県
高山 夏希	takayama_natsuki@example.com	富山県
上山 優	kamiyama_yuu@example.com	島根県
塩谷 りえ	shioya_rie@example.com	京都府
上野 竜也	ueno_tatsuya1@example.com	福岡県
浜田 鉄二	hamada_tetsuji@example.com	大阪府
野田 寛治	noda_kanji@example.com	埼玉県
吉川 竜也	kikkawa_tatsuya@example.com	鹿児島県
篠田 徹	shinoda_tohru@example.com	新潟県
荻野 砂羽	ogino_sawa@example.com	新潟県
森下 マサカズ	morishita_masakazu@example.com	埼玉県
米山 奈月	yoneyama_natsuki@example.com	京都府
松野 涼	matsuno_ryou@example.com	三重県
橋口 瞳	hashiguchi_hitomi@example.com	岐阜県
武藤 早紀	mutou_saki@example.com	岡山県
星野 健	hoshino_ken@example.com	神奈川県
根本 涼	nemoto_ryou1@example.com	埼玉県
西 幸平	nishi_kouhei@example.com	新潟県
西岡 かおり	nishioka_kaori@example.com	岡山県
大崎 サダヲ	oosaki_sadawo@example.com	富山県
宮部 京子	miyabe_kyouko@example.com	宮城県
沢村 ケンイチ	sawamura_kenichi@example.com	神奈川県
藤野 栄一	fujino_eiichi@example.com	福島県
川原 理紗	kawahara_risa1@example.com	大阪府
車 徹	kuruma_tooru@example.com	東京都
ほしの 由宇	hoshino_yuu@example.com	北海道
新田 みゆき	arata_miyuki@example.com	神奈川県
水谷 恵望子	mizutani_emiko@example.com	秋田県
角田 朝香	kadota_asaka@example.com	東京都
松居 そら	matsui_sora@example.com	宮城県
野村 建	nomura_ken@example.com	静岡県
大高 浩太郎	oodaka_koutarou@example.com	北海道
梅村 はるみ	umemura_harumi@example.com	島根県
今田 哲平	imada_teppei@example.com	京都府
中山 友香	nakayama_tomoka@example.com	新潟県
本田 進	honnda_susumu@example.com	奈良県
岩間 宏	iwama_hiroshi@example.com	大阪府
鶴岡 詩織	tsuruoka_shiori@example.com	大阪府
竹中 陽子	takenaka_youko@example.com	埼玉県
松尾 了	matsuo_ryou@example.com	静岡県
楠 由宇	kusunoki_yuu@example.com	兵庫県
高岡 美幸	takaoka_miyuki@example.com	長崎県
北条 隆之介	houjou_ryuunosuke@example.com	静岡県
高松 剛基	takamatsu_yoshiki@example.com	千葉県
富永 博之	tominaga_hiroyuki@example.com	東京都
河本 早紀	koumoto_saki@example.com	沖縄県
辻本 将也	tsujimoto_masaya@example.com	埼玉県
小市 剛基	koichi_yoshiki@example.com	宮城県
長谷川 光	hasegawa_hikaru@example.com	広島県
大倉 完爾	ookura_kanji@example.com	兵庫県
奥野 夏希	okuno_natsuki@example.com	神奈川県
山村 美優	yamamura_myuu@example.com	東京都
平田 ひとり	hirata_hitori@example.com	福島県
永山 圭	nagayama_kei@example.com	東京都
大槻 亜希	ootsuki_aki@example.com	和歌山県
深沢 完爾	fukazawa_kanji@example.com	大阪府
小沼 ひろ子	konuma_hiroko@example.com	兵庫県
久保 米蔵	kubo_yonezou@example.com	大阪府
小柳 フミヤ	koyanagi_fumiya@example.com	東京都
北条 智花	houjou_tomoka@example.com	岐阜県
手塚 隆太	teduka_ryuuta@example.com	埼玉県
須藤 博之	sudou_hiroyuki@example.com	新潟県
神崎 一輝	kannzaki_kazuki@example.com	千葉県
福沢 雅之	fukuzawa_masayuki@example.com	群馬県
宮地 剛基	miyaji_yoshiki@example.com	埼玉県
柴山 敏和	shibayama_toshikazu@example.com	福岡県
小野田 大樹	onoda_hiroki@example.com	群馬県
平 希	taira_nozomi@example.com	岩手県
松井 ひとり	matsui_hitori@example.com	岡山県
中原 美紀	nakahara_miki@example.com	宮崎県
磯部 貴美子	isobe_kimiko@example.com	兵庫県
三宅 昌代	miyake_masayo@example.com	大阪府
真田 夏希	sanada_natsuki@example.com	沖縄県
石田 雅功	ishida_masatoshi@example.com	福岡県
草村 光臣	kusamura_mitsuomi@example.com	千葉県
古田 蒼甫	furuta_sousuke@example.com	兵庫県
吹石 美幸	fukiishi_miyuki1@example.com	神奈川県
鎌田 拓郎	kamata_takurou@example.com	山口県
根岸 祐基	negishi_yuuki@example.com	愛知県
一青 陽子	hitoto_youko@example.com	茨城県
牧田 啓介	makita_keisuke@example.com	大阪府
合田 友香	aida_tomoka@example.com	秋田県
奥村 兼	okumura_ken@example.com	東京都
菅井 悟志	sugai_satoshi@example.com	広島県
柴田 三郎	shibata_saburou@example.com	広島県
桜井 郁恵	sakurai_ikue@example.com	新潟県
三枝 遥	sannshi_haruka@example.com	大阪府
岩間 美佳	iwama_mika@example.com	山口県
平林 徹	hirabayashi_tohru@example.com	富山県
津田 聡	tsuda_satoshi@example.com	高知県
沢田 育子	sawada_ikuko@example.com	長崎県
外山 寛治	sotoyama_kanji@example.com	佐賀県
原口 洋介	haraguchi_yousuke@example.com	兵庫県
保坂 慎之介	hosaka_shinnosuke@example.com	東京都
高山 徹平	takayama_teppei@example.com	東京都
湊 窈	minato_you@example.com	東京都
鈴木 文世	suzuki_fumiyo@example.com	愛媛県
長沢 小雁	nagasawa_kogan@example.com	東京都
角田 璃奈子	kadota_rinako@example.com	新潟県
片桐 薫	katagiri_kaoru1@example.com	福岡県
小久保 恵子	kokubo_keiko@example.com	鹿児島県
菅野 あさみ	kanno_asami@example.com	秋田県
吉野 三省	yoshino_sansei@example.com	北海道
山岡 ケンイチ	yamaoka_kenichi@example.com	岡山県
堀江 あい	horie_ai@example.com	兵庫県
影山 亮	kageyama_ryou@example.com	岐阜県
小室 未華子	komuro_mikako@example.com	北海道
藤島 友也	fujishima_tomoya@example.com	石川県
柳 誠治	yanagi_seiji@example.com	沖縄県
野本 祐基	nomoto_yuuki@example.com	愛知県
唐沢 菜摘	karasawa_natsumi@example.com	大阪府
前川 裕次郎	maekawa_yuujirou@example.com	沖縄県
門田 広之	kadota_hiroyuki@example.com	東京都
高崎 圭	takasaki_kei@example.com	千葉県
藤岡 雅之	fujioka_masayuki@example.com	埼玉県
中岡 莉沙	nakaoka_risa@example.com	北海道
本村 啓介	honnmura_keisuke@example.com	北海道
秦 ちえみ	hata_chiemi@example.com	沖縄県
塩田 しほり	shiota_shihori@example.com	福岡県
南 遥	minami_haruka@example.com	愛知県
玉井 愛	tamai_ai@example.com	埼玉県
西島 瞬	nishijima_shun@example.com	大阪府
松下 惇	matsushita_jun@example.com	東京都
増井 佑	masui_tasuku@example.com	福岡県
寺島 健	terajima_ken@example.com	埼玉県
山下 充則	yamashita_mitsunori@example.com	北海道
大久保 祐一	ookubo_yuuichi@example.com	埼玉県
小野 サダヲ	ono_sadawo@example.com	神奈川県
八十田 由宇	yasoda_yuu@example.com	神奈川県
田島 まさし	tajima_masashi@example.com	神奈川県
森下 愛	morishita_ai@example.com	神奈川県
永井 花	nagai_hana@example.com	群馬県
阿部 悟志	abe_satoshi@example.com	愛媛県
日下部 建	kusakabe_ken@example.com	長崎県
藤沢 大	fujisawa_masaru@example.com	兵庫県
平野 憲一	hirano_kenichi@example.com	東京都
新村 慶二	niimura_keiji@example.com	沖縄県
山城 優	yamashiro_yuu@example.com	富山県
大和田 克実	oowada_katsumi@example.com	埼玉県
日下 まひる	hinoshita_mahiru@example.com	埼玉県
神保 優	jinbo_yuu@example.com	新潟県
小菅 さとみ	kosuge_satomi@example.com	東京都
海野 晃司	umino_kouji@example.com	千葉県
小池 莉沙	koike_risa@example.com	愛知県
小野 啓介	ono_keisuke@example.com	静岡県
山村 広之	yamamura_hiroyuki@example.com	福岡県
小川 里奈	ogawa_rina@example.com	北海道
武藤 宏	mutou_hiroshi@example.com	千葉県
平井 愛梨	hirai_airi@example.com	富山県
伊藤 そら	itou_sora@example.com	埼玉県
奥寺 かおり	okudera_kaori@example.com	大阪府
徳田 敏和	tokuta_toshikazu@example.com	神奈川県
高島 宏行	takashima_hiroyuki@example.com	北海道
野中 亮	nonaka_ryou@example.com	静岡県
金城 しぼり	kanashiro_shibori@example.com	神奈川県
野呂 知世	noro_chise@example.com	福井県
亀田 茂樹	kameda_shigeki@example.com	栃木県
沼田 華子	numata_hanako@example.com	福岡県
古田 広之	furuta_hiroyuki@example.com	静岡県
白石 聖陽	shiraishi_masaaki@example.com	山梨県
塩谷 直人	shiotani_naoto@example.com	新潟県
小谷 桃子	kotani_momoko@example.com	神奈川県
山下 裕次郎	yamashita_yuujirou@example.com	福井県
曽我 龍吉	soga_ryuukichi@example.com	福島県
上山 真希	kamiyama_maki@example.com	北海道
木田 鉄二	kida_tetsuji@example.com	静岡県
岸 茜	kishi_akane@example.com	福島県
岩沢 ひとみ	iwasawa_hitomi@example.com	和歌山県
加瀬 怜奈	kase_reina@example.com	愛知県
市田 直人	ichida_naoto@example.com	北海道
沖 淳子	oki_atsuko@example.com	埼玉県
橘 裕次郎	tachibana_yuujirou@example.com	京都府
小原 幸平	ohara_kouhei@example.com	兵庫県
熊倉 三省	kumakura_sansei@example.com	東京都
内田 恭子	uchida_kyouko@example.com	鹿児島県
井田 貴嶺	ida_takane@example.com	島根県
小杉 健	kosugi_ken@example.com	新潟県
加藤 竜也	katou_tatsuya@example.com	愛知県
塚本 真一	tsukamoto_shinichi@example.com	北海道
勝地 莉緒	katsudi_rio@example.com	兵庫県
多岐川 那奈	takigawa_nana@example.com	山形県
神崎 大樹	kannzaki_hiroki@example.com	秋田県
長沢 三郎	nagasawa_saburou@example.com	愛媛県
酒井 杏	sakai_ann@example.com	鹿児島県
滝 璃子	taki_riko@example.com	熊本県
山中 光	yamanaka_hikaru@example.com	兵庫県
富山 恵麻	tomiyama_ema@example.com	岡山県
波多野 未來	hatano_mirai@example.com	静岡県
佐藤 花緑	satou_karoku@example.com	岩手県
大谷 充則	ootani_mitsunori@example.com	東京都
山中 三省	yamanaka_sansei@example.com	茨城県
水嶋 芽以	mizushima_mei@example.com	神奈川県
上杉 真一	uesugi_shinichi@example.com	埼玉県
徳永 浩介	tokunaga_kousuke@example.com	山口県
本山 恵梨香	honnyama_erika@example.com	神奈川県
平野 染五郎	hirano_somegorou@example.com	和歌山県
松永 美菜	matsunaga_mina@example.com	群馬県
志田 光	shida_hikaru@example.com	兵庫県
成田 ケンイチ	narita_kenichi@example.com	福岡県
窪塚 晃司	kuboduka_kouji@example.com	千葉県
日高 きみまろ	hidaka_kimimaro@example.com	群馬県
山崎 美帆	yamazaki_miho@example.com	兵庫県
亀山 陽子	kameyama_youko@example.com	茨城県
船橋 奈月	funabashi_natsuki@example.com	栃木県
熊沢 まみ	kumasawa_mami@example.com	北海道
野口 真一	noguchi_shinichi@example.com	神奈川県
岡 智花	oka_tomoka@example.com	愛知県
福沢 ひかり	fukuzawa_hikari@example.com	青森県
浅見 ノブヒコ	asami_nobuhiko@example.com	大阪府
飯野 怜奈	iino_reina@example.com	大阪府
平林 雅之	hirabayashi_masayuki@example.com	静岡県
飯田 芽以	iida_mei@example.com	東京都
小玉 由宇	kodama_yuu@example.com	千葉県
本山 茜	honnyama_akane@example.com	神奈川県
大平 剛基	oohira_yoshiki@example.com	大阪府
重田 誠治	shigeta_seiji@example.com	北海道
土井 あさみ	doi_asami@example.com	山口県
高田 麗奈	takada_rena@example.com	徳島県
板橋 薫	itabashi_kaoru@example.com	福岡県
下山 由樹	shimoyama_yuki@example.com	大分県
堤 倫子	tsutsumi_noriko@example.com	広島県
妹尾 はじめ	seo_hajime@example.com	愛知県
牧野 翔太	makino_shouta@example.com	栃木県
丹羽 一輝	tannba_kazuki@example.com	神奈川県
小幡 愛梨	obata_airi@example.com	大阪府
武 進	take_susumu@example.com	静岡県
金田 隼士	kaneda_shunji@example.com	福岡県
高見 満	takami_mitsuru@example.com	北海道
富永 竜也	tominaga_tatsuya@example.com	島根県
立川 育子	tachikawa_ikuko@example.com	東京都
山中 広司	yamanaka_kouji@example.com	兵庫県
小林 亮介	kobayashi_ryousuke@example.com	東京都
高木 さやか	takagi_sayaka@example.com	秋田県
落合 樹里	ochiai_juri@example.com	埼玉県
大島 蒼甫	ooshima_sousuke@example.com	北海道
林 隆之介	hayashi_ryuunosuke@example.com	福井県
細田 玲那	hosoda_rena@example.com	茨城県
豊田 花	toyota_hana@example.com	神奈川県
吉原 涼子	yoshiwara_ryouko@example.com	埼玉県
高瀬 祐一	takase_yuuichi@example.com	茨城県
竹中 竜也	takenaka_tatsuya@example.com	大分県
山西 達士	yamanishi_tatsuhito@example.com	福岡県
長沢 三郎	nagasawa_saburou1@example.com	神奈川県
牧田 建	makita_ken@example.com	埼玉県
大矢 さやか	ooya_sayaka@example.com	神奈川県
並木 さとみ	namiki_satomi@example.com	北海道
沢尻 たかお	sawajiri_takao@example.com	奈良県
小原 光	ohara_hikaru@example.com	神奈川県
北川 長利	kitakawa_nagatoshi@example.com	広島県
植木 華子	ueki_hanako@example.com	神奈川県
牧瀬 真奈美	makise_manami@example.com	神奈川県
三木 遥	miki_haruka@example.com	埼玉県
島田 完爾	shimada_kanji1@example.com	秋田県
坪井 芽以	tsuboi_mei@example.com	山口県
葛西 小百合	kasai_sayuri@example.com	岡山県
若山 有海	wakayama_ami@example.com	埼玉県
劇団 杏	gekidan_ann@example.com	神奈川県
青柳 ひろ子	aoyagi_hiroko@example.com	静岡県
古山 功補	furuyama_kousuke@example.com	福岡県
平賀 満	hiraga_mitsuru@example.com	東京都
菅澤 淳	sugasawa_atsushi@example.com	東京都
佐藤 さやか	satou_sayaka@example.com	大阪府
根本 守	nemoto_mamoru@example.com	高知県
島 剛基	shima_yoshiki@example.com	栃木県
柳田 紗季	yanagida_saki@example.com	東京都
田原 聖陽	tahara_masaaki@example.com	埼玉県
日野 賢治	hino_kenji@example.com	群馬県
古賀 弘也	koga_hironari@example.com	岩手県
西田 美佳	nishida_mika@example.com	新潟県
岩井 公顕	iwai_kimiaki@example.com	東京都
秦 メイサ	hata_meisa@example.com	神奈川県
梅本 まさみ	umemoto_masami@example.com	岐阜県
田口 郁恵	taguchi_ikue@example.com	福岡県
下川 薫	shimokawa_kaoru@example.com	埼玉県
小野田 はるみ	onoda_harumi@example.com	三重県
松島 麻緒	matsushima_mao@example.com	大分県
日高 雅彦	hidaka_masahiko@example.com	広島県
山元 めぐみ	yamamoto_megumi@example.com	大阪府
井村 憲史	imura_norihito@example.com	茨城県
窪田 朝陽	kubota_asahi@example.com	埼玉県
河田 はじめ	kawata_hajime@example.com	岩手県
西井 昴	nishii_subaru@example.com	鹿児島県
深沢 照生	fukazawa_teruo@example.com	埼玉県
大場 沙耶	ooba_saya@example.com	大阪府
武田 丈史	takeda_takeshi@example.com	三重県
堀 仁	hori_jin@example.com	神奈川県
五大 剛基	godai_yoshiki@example.com	埼玉県
毛利 未來	mouri_mirai@example.com	沖縄県
大地 翔	oochi_shou@example.com	三重県
河合 りえ	kawai_rie@example.com	鹿児島県
金丸 一	kanamaru_hajime@example.com	東京都
大地 佑	oochi_tasuku@example.com	神奈川県
畠山 充則	hatayama_mitsunori@example.com	兵庫県
長岡 直人	nagaoka_naoto@example.com	兵庫県
半田 功補	hannda_kousuke@example.com	北海道
平賀 愛梨	hiraga_airi@example.com	福島県
福士 貴美子	fukushi_kimiko@example.com	大阪府
石原 裕次郎	ishihara_yuujirou@example.com	山形県
高井 サンタマリア	takai_stmaria@example.com	福岡県
足立 丈史	adachi_takeshi@example.com	埼玉県
志水 禄郎	shimizu_rokurou@example.com	滋賀県
榎本 さんま	enomoto_sanma@example.com	福島県
黒田 奈央	kurota_nao@example.com	秋田県
小日向 浩正	kohinata_hiromasa@example.com	福岡県
井本 勝久	imoto_katsuhisa@example.com	愛知県
伊藤 友以乃	itou_yuino@example.com	京都府
大塚 勇介	ootsuka_yuusuke@example.com	愛知県
田沢 晋也	tazawa_shinya@example.com	東京都
植田 ジローラモ	ueta_girolamo@example.com	山口県
大貫 祐基	oonuki_yuuki@example.com	岩手県
小柳 精児	koyanagi_seiji@example.com	秋田県
村木 茂樹	muraki_shigeki@example.com	兵庫県
島村 朝香	shimamura_asaka@example.com	北海道
松崎 竜也	matsuzaki_tatsuya@example.com	神奈川県
江原 あさみ	ehara_asami@example.com	東京都
北 獅童	kita_shidou@example.com	兵庫県
小西 法子	konishi_noriko@example.com	群馬県
田原 良介	tahara_ryousuke@example.com	富山県
中村 豊	nakamura_yutaka@example.com	群馬県
塩見 茂樹	shiomi_shigeki@example.com	福井県
山川 一哉	yamakawa_kazuya@example.com	北海道
堀 竜也	hori_tatsuya@example.com	北海道
大内 真悠子	oouchi_mayuko@example.com	青森県
半田 和久	hannda_kazuhisa@example.com	茨城県
本間 くるみ	honma_kurumi@example.com	東京都
佐伯 功補	saeki_kousuke@example.com	長崎県
細谷 育子	hosoya_ikuko@example.com	愛知県
小椋 ちえみ	ogura_chiemi@example.com	神奈川県
麻生 陽介	asou_yousuke@example.com	大阪府
長瀬 朝陽	nagase_asahi@example.com	長崎県
石橋 敏也	ishibashi_toshiya@example.com	東京都
伊沢 真吾	izawa_shingo@example.com	鹿児島県
橋本 さとみ	hashimoto_satomi@example.com	福岡県
久野 雅彦	hisano_masahiko@example.com	愛知県
石垣 愛子	ishigaki_aiko@example.com	広島県
石倉 彩	ishikura_aya@example.com	北海道
草野 晃司	kusano_kouji@example.com	大阪府
保坂 優一	hosaka_yuuichi@example.com	兵庫県
戸田 京子	toda_kyouko@example.com	埼玉県
倉田 鉄二	kurata_tetsuji@example.com	長崎県
滝川 さんま	takigawa_sanma@example.com	三重県
薬師丸 窈	yakushimaru_you@example.com	兵庫県
北島 きみまろ	kitajima_kimimaro@example.com	三重県
藤澤 くるみ	fujisawa_kurumi@example.com	東京都
小町 恵梨香	komachi_erika@example.com	三重県
三沢 景子	misawa_keiko@example.com	福岡県
熊沢 陽介	kumasawa_yousuke@example.com	東京都
瀬戸 美菜	seto_mina@example.com	東京都
牧野 早織	makino_saori@example.com	東京都
岩城 倫子	iwaki_noriko@example.com	埼玉県
安田 瞬	yasuda_shun@example.com	香川県
竹本 碧海	takemoto_ouga@example.com	群馬県
平松 雅功	hiramatsu_masatoshi@example.com	東京都
芳賀 信輔	haga_shinsuke@example.com	山口県
奥 茜	oku_akane@example.com	千葉県
石井 勇太	ishii_yuuta@example.com	愛知県
菊池 なぎさ	kikuchi_nagisa@example.com	福島県
亀田 人志	kameda_hitoshi@example.com	京都府
今 ケンイチ	ima_kenichi@example.com	栃木県
瀬尾 陽子	seo_youko@example.com	愛知県
津田 綾女	tsuda_ayame@example.com	高知県
浅井 亮	asai_ryou@example.com	北海道
美輪 瞬	miwa_shun@example.com	神奈川県
福井 美智子	fukui_michiko@example.com	大阪府
三谷 美帆	mitani_miho@example.com	福井県
岸本 敦	kishimoto_atsushi@example.com	北海道
井田 ヒカル	ida_hikaru1@example.com	埼玉県
小西 杏	konishi_ann@example.com	沖縄県
松田 美佐子	matsuda_misako@example.com	奈良県
藤森 進	fujimori_susumu@example.com	岡山県
志賀 光洋	shiga_mitsuhiro@example.com	長野県
小幡 菜々美	obata_nanami@example.com	北海道
山上 恵梨香	yamagami_erika1@example.com	大阪府
北条 慢太郎	houjou_mantarou@example.com	埼玉県
村山 桃子	murayama_momoko@example.com	滋賀県
今村 杏	imamura_ann@example.com	栃木県
町田 だん吉	machida_dankichi@example.com	栃木県
水野 健	mizuno_ken@example.com	山形県
染谷 研二	someya_kenji@example.com	鹿児島県
緒方 美和子	ogata_miwako@example.com	埼玉県
武内 璃子	takeuchi_riko@example.com	兵庫県
足立 鉄洋	adachi_tetsuhiro@example.com	北海道
山形 未來	yamagata_mirai@example.com	兵庫県
花岡 美帆	hanaoka_miho@example.com	奈良県
高梨 和之	takanashi_kazuyuki@example.com	千葉県
菅澤 憲史	sugasawa_norihito@example.com	東京都
美輪 薫	miwa_kaoru@example.com	秋田県
土谷 豊	tsuchiya_yutaka@example.com	北海道
沖田 詩織	okita_shiori@example.com	愛知県
浅田 桃子	asada_momoko@example.com	兵庫県
古谷 菜々美	furutani_nanami@example.com	北海道
柴咲 あさみ	shibasaki_asami@example.com	兵庫県
丸山 まひる	maruyama_mahiru@example.com	東京都
坂元 勝久	sakamoto_katsuhisa@example.com	埼玉県
八木 小雁	yagi_kogan@example.com	京都府
五大 あさみ	godai_asami@example.com	高知県
小林 亜希	kobayashi_aki@example.com	福島県
入江 七世	irie_nanase@example.com	鳥取県
金井 光洋	kanai_mitsuhiro@example.com	静岡県
塩見 奈月	shiomi_natsuki@example.com	神奈川県
笹川 優	sasagawa_yuu@example.com	神奈川県
飯野 美紀	iino_miki@example.com	長崎県
福田 陽子	fukuda_youko@example.com	静岡県
橋口 博明	hashiguchi_hiroaki@example.com	北海道
浅川 結子	asakawa_yuuko@example.com	埼玉県
堀川 碧海	horikawa_ouga@example.com	東京都
六角 剛基	rokkaku_yoshiki@example.com	鹿児島県
片桐 メイサ	katagiri_meisa@example.com	静岡県
西原 三省	nishihara_sansei@example.com	山梨県
寺西 高史	teranishi_takashi@example.com	静岡県
吉岡 洋介	yoshioka_yousuke@example.com	愛知県
武 かおり	take_kaori@example.com	山形県
安斎 コウ	annzai_kou@example.com	埼玉県
三浦 洋	miura_you@example.com	神奈川県
矢部 達士	yabe_tatsuhito@example.com	富山県
北沢 りえ	kitazawa_rie@example.com	埼玉県
中川 未來	nakagawa_mirai@example.com	秋田県
金山 一代	kanayama_kazuyo@example.com	兵庫県
金谷 夏希	kanaya_natsuki@example.com	宮崎県
玉城 和久	tamaki_kazuhisa@example.com	愛知県
小原 綾女	ohara_ayame@example.com	愛知県
成海 由宇	narumi_yuu@example.com	和歌山県
小沼 瑠璃亜	konuma_ruria@example.com	滋賀県
中根 勇介	nakane_yuusuke@example.com	愛媛県
水野 裕司	mizuno_yuuji@example.com	香川県
横山 ケンイチ	yokoyama_kenichi@example.com	宮城県
深田 美希	fukada_miki@example.com	鳥取県
神田 真悠子	kannda_mayuko@example.com	神奈川県
角谷 亮	kadotani_ryou@example.com	福岡県
堤 淳子	tsutsumi_atsuko@example.com	愛知県
鶴田 明宏	tsuruta_akihiro@example.com	青森県
茂木 美月	mogi_miduki@example.com	愛知県
米沢 ヒロ	yonezawa_hiro@example.com	東京都
寺岡 瞬	teraoka_shun@example.com	愛知県
橘 春樹	tachibana_haruki@example.com	茨城県
菅 聡	suga_satoshi@example.com	東京都
鹿手袋 博之	shikatebukuro_hiroyuki@example.com	群馬県
岩村 雅彦	iwamura_masahiko@example.com	愛知県
村松 基祐	muramatsu_kisuke@example.com	石川県
植松 兼	uematsu_ken@example.com	広島県
宮下 浩太郎	miyashita_koutarou@example.com	茨城県
金山 あき	kanayama_aki@example.com	宮崎県
吉川 ヒロ	kikkawa_hiro@example.com	佐賀県
坂田 雅功	sakata_masatoshi@example.com	兵庫県
浅野 慢太郎	asano_mantarou@example.com	静岡県
寺西 薫	teranishi_kaoru@example.com	大阪府
関根 遥	sekine_haruka1@example.com	新潟県
岸 麗奈	kishi_rena@example.com	兵庫県
筒井 恵梨香	tsutsui_erika@example.com	三重県
石坂 サンタマリア	ishizaka_stmaria@example.com	兵庫県
紺野 祐一	konnno_yuuichi@example.com	千葉県
石倉 恵子	ishikura_keiko@example.com	熊本県
勝又 美帆	katsumata_miho@example.com	東京都
木下 綾	kinoshita_aya@example.com	和歌山県
寺井 幸子	terai_sachiko@example.com	北海道
伊丹 勇一	itami_yuuichi@example.com	栃木県
亀山 瑠璃亜	kameyama_ruria@example.com	埼玉県
手塚 亮	teduka_ryou@example.com	北海道
川中 愛子	kawanaka_aiko@example.com	広島県
島崎 雅彦	shimazaki_masahiko@example.com	福岡県
福士 昴	fukushi_subaru@example.com	兵庫県
多岐川 幸平	takigawa_kouhei@example.com	島根県
大林 丈雄	oobayashi_takeo@example.com	新潟県
福島 窈	fukushima_you1@example.com	大阪府
中林 蒼甫	nakabayashi_sousuke@example.com	愛知県
楠本 淳	kusumoto_atsushi@example.com	愛知県
八田 郁恵	yatsuda_ikue@example.com	長崎県
坂本 昌代	sakamoto_masayo@example.com	長野県
三枝 恭子	sannshi_kyouko@example.com	千葉県
対馬 剛基	tsushima_yoshiki@example.com	石川県
市川 愛	ichikawa_ai@example.com	茨城県
仲田 涼	nakata_ryou@example.com	沖縄県
五大 満	godai_mitsuru@example.com	新潟県
臼井 郁恵	usui_ikue@example.com	東京都
山田 フミヤ	yamada_fumiya@example.com	長崎県
加瀬 涼	kase_ryou@example.com	福岡県
貫地谷 麻緒	kanjiya_mao@example.com	兵庫県
天野 寿明	amano_toshiaki@example.com	愛知県
海野 さとみ	umino_satomi@example.com	埼玉県
小柳 鉄洋	koyanagi_tetsuhiro@example.com	愛知県
小林 瞬	kobayashi_shun@example.com	北海道
山上 里奈	yamagami_rina@example.com	岡山県
長尾 徹	nagao_tohru@example.com	兵庫県
岩田 早紀	iwata_saki@example.com	愛知県
布川 夏空	fukawa_sora@example.com	香川県
大沢 まひる	oosawa_mahiru@example.com	大阪府
曽根 聡	sone_satoshi@example.com	北海道
岩城 七世	iwaki_nanase@example.com	岡山県
奥寺 直人	okudera_naoto@example.com	大阪府
手島 一	tejima_hajime@example.com	北海道
石井 妃里	ishii_yuri@example.com	山形県
おかやま 璃奈子	okayama_rinako@example.com	長野県
三浦 妃里	miura_yuri@example.com	神奈川県
須藤 染五郎	sudou_somegorou@example.com	千葉県
三村 瞳	mimura_hitomi@example.com	大阪府
土田 敏也	tsuchida_toshiya@example.com	広島県
神谷 翔子	kamiya_shouko@example.com	北海道
小関 礼子	kozeki_reiko@example.com	京都府
石倉 雅彦	ishikura_masahiko@example.com	岡山県
藤村 明慶	fujimura_akiyoshi@example.com	兵庫県
日高 一恵	hidaka_kadue@example.com	三重県
村中 玲那	muranaka_rena@example.com	京都府
川端 美希	kawabata_miki@example.com	大阪府
日高 憲史	hidaka_norihito1@example.com	福岡県
古山 一哉	furuyama_kazuya@example.com	北海道
富樫 涼	togashi_ryou@example.com	愛知県
寺島 龍吉	terajima_ryuukichi@example.com	北海道
宇多田 正義	utada_masayoshi@example.com	青森県
とよた 竜也	toyota_tatsuya@example.com	香川県
本上 明慶	honjo_akiyoshi@example.com	広島県
横田 鉄二	yokota_tetsuji@example.com	福島県
浜口 里奈	hamaguchi_rina@example.com	新潟県
根岸 賢治	negishi_kenji@example.com	兵庫県
鎌田 健	kamata_ken@example.com	群馬県
原田 栄一	harada_eiichi@example.com	東京都
宮内 明宏	miyauchi_akihiro@example.com	北海道
比嘉 ひとみ	hiyoshi_hitomi@example.com	大阪府
高畑 優	takabata_yuu@example.com	東京都
安座間 真一	azama_shinichi@example.com	埼玉県
北条 瑠璃亜	houjou_ruria@example.com	兵庫県
浜口 あさみ	hamaguchi_asami@example.com	青森県
真鍋 はるか	manabe_haruka@example.com	愛知県
菅井 景子	sugai_keiko@example.com	京都府
ほしの 法子	hoshino_noriko@example.com	福井県
太田 太朗	oota_tarou@example.com	東京都
篠山 友也	shinoyama_tomoya@example.com	石川県
氏家 勇太	ujiie_yuuta@example.com	東京都
山田 啓介	yamada_keisuke@example.com	熊本県
石田 浩正	ishida_hiromasa@example.com	神奈川県
下山 千夏	shimoyama_chinatsu@example.com	神奈川県
深沢 法嗣	fukazawa_houshi@example.com	群馬県
松永 寛	matsunaga_hiroshi@example.com	福岡県
沢尻 一代	sawajiri_kazuyo@example.com	東京都
内野 遥	uchino_haruka@example.com	埼玉県
黒木 杏	kuroki_ann@example.com	静岡県
後藤 直人	gotou_naoto@example.com	北海道
古沢 一徳	furusawa_ittoku@example.com	福島県
塩見 満	shiomi_mitsuru@example.com	山口県
村瀬 翔	murase_shou@example.com	千葉県
北川 勇	kitakawa_yuu@example.com	岐阜県
望月 美月	mochiduki_miduki@example.com	神奈川県
相馬 聖陽	aiba_masaaki@example.com	東京都
柳 雅彦	yanagi_masahiko1@example.com	徳島県
内野 結衣	uchino_yui@example.com	神奈川県
横井 さとみ	yokoi_satomi@example.com	長野県
谷村 隼士	tanimura_shunji@example.com	新潟県
深田 栄一	fukada_eiichi@example.com	大阪府
田辺 有海	tanabe_ami@example.com	熊本県
仲村 達士	nakamura_tatsuhito@example.com	大阪府
矢田 瑠璃亜	yada_ruria1@example.com	愛知県
山内 一	yamanouchi_hajime@example.com	三重県
緒形 春樹	ogata_haruki@example.com	千葉県
小坂 敏也	kozaka_toshiya@example.com	兵庫県
柳沢 芽以	yanagisawa_mei@example.com	岩手県
杉原 優一	sugihara_yuuichi@example.com	茨城県
萩原 一	hagiwara_hajime@example.com	岐阜県
沖 聡	oki_satoshi@example.com	群馬県
瀬川 雅功	segawa_masatoshi@example.com	東京都
安 隆博	yasu_takahiro@example.com	埼玉県
八十田 隆太	yasoda_ryuuta@example.com	神奈川県
川原 涼	kawahara_ryou@example.com	東京都
寺脇 杏	terawaki_ann@example.com	大阪府
堤 憲一	tsutsumi_kenichi@example.com	滋賀県
島津 さやか	shimadu_sayaka@example.com	埼玉県
平田 礼子	hirata_reiko1@example.com	山形県
平尾 恵子	hirao_keiko@example.com	神奈川県
山崎 大	yamazaki_masaru@example.com	東京都
青野 栄一	aono_eiichi@example.com	徳島県
田尻 朝陽	tajiri_asahi@example.com	静岡県
山川 愛菜	yamakawa_aina@example.com	群馬県
平林 和香	hirabayashi_waka@example.com	長野県
足立 蒼甫	adachi_sousuke@example.com	鹿児島県
今泉 ケンイチ	imaizumi_kenichi@example.com	鹿児島県
米山 美幸	yoneyama_miyuki1@example.com	新潟県
車 鉄洋	kuruma_tetsuhiro1@example.com	山梨県
小久保 勝久	kokubo_katsuhisa@example.com	長崎県
福士 はるか	fukushi_haruka@example.com	大阪府
高村 ヒカル	takamura_hikaru@example.com	東京都
鶴田 杏	tsuruta_ann@example.com	神奈川県
重松 拓郎	shigematsu_takurou@example.com	愛知県
金丸 俊二	kanamaru_shunji@example.com	三重県
小椋 めぐみ	ogura_megumi@example.com	愛知県
竹内 碧海	takeuchi_ouga@example.com	新潟県
草村 結衣	kusamura_yui@example.com	東京都
岩本 はじめ	iwamoto_hajime@example.com	京都府
天野 花緑	amano_karoku@example.com	岐阜県
早川 ひとみ	hayakawa_hitomi@example.com	北海道
早美 ケンイチ	hayami_kenichi@example.com	福島県
前田 美里	maeda_miri@example.com	東京都
中本 沙知絵	nakamoto_sachie@example.com	福岡県
哀川 佳乃	aikawa_yoshino@example.com	福島県
宮原 未華子	miyahara_mikako@example.com	静岡県
山本 右京	yamamoto_ukyou@example.com	奈良県
牧瀬 怜奈	makise_reina@example.com	千葉県
五味 敏也	gomi_toshiya@example.com	大分県
楠 丈雄	kusunoki_takeo@example.com	埼玉県
辻本 早紀	tsujimoto_saki@example.com	山梨県
滝口 新太	takiguchi_arata@example.com	福岡県
松山 まみ	matsuyama_mami@example.com	兵庫県
小平 れいな	kohira_reina@example.com	群馬県
荻原 正敏	hagiwara_masatoshi@example.com	兵庫県
荒井 洋	arai_you@example.com	千葉県
遠山 真一	tooyama_shinichi@example.com	東京都
下川 優	shimokawa_yuu@example.com	熊本県
片岡 米蔵	kataoka_yonezou@example.com	神奈川県
松沢 一恵	matsuzawa_kadue@example.com	神奈川県
青山 遥	aoyama_haruka@example.com	大阪府
柳 仁	yanagi_jin@example.com	兵庫県
西川 沙耶	nishikawa_saya@example.com	新潟県
大倉 広司	ookura_kouji@example.com	千葉県
矢作 将也	yahagi_masaya@example.com	愛知県
高崎 郁恵	takasaki_ikue@example.com	群馬県
大城 勇	ooshiro_yuu@example.com	東京都
宇多田 杏	utada_ann@example.com	北海道
海老原 秀樹	ebihara_hideki@example.com	兵庫県
小松 三郎	komatsu_saburou@example.com	高知県
片岡 隆博	kataoka_takahiro@example.com	愛媛県
下村 かおり	shimomura_kaori@example.com	東京都
福地 瞬	fukuchi_shun@example.com	愛媛県
金城 拓郎	kanashiro_takurou@example.com	宮城県
古田 春樹	furuta_haruki@example.com	愛媛県
佐古 満	sako_mitsuru@example.com	神奈川県
高田 美紀	takada_miki@example.com	静岡県
小日向 奈々	kohinata_nana@example.com	千葉県
深沢 和久	fukazawa_kazuhisa@example.com	静岡県
藤村 はるか	fujimura_haruka@example.com	福岡県
野呂 翔	noro_shou@example.com	奈良県
工藤 花	kudou_hana@example.com	愛知県
角田 浩正	kadota_hiromasa@example.com	香川県
青山 まみ	aoyama_mami@example.com	兵庫県
有村 雄太	arimura_yuuta@example.com	大分県
沢 恵梨香	sawa_erika@example.com	東京都
古山 はるか	furuyama_haruka@example.com	大阪府
小木 裕司	ogi_yuuji@example.com	静岡県
飯島 涼	iijima_ryou@example.com	奈良県
小野 ひかり	ono_hikari@example.com	埼玉県
高田 愛梨	takada_airi@example.com	青森県
小島 寛治	kojima_kanji@example.com	三重県
浅野 ジョージ	asano_george@example.com	宮城県
津田 雅之	tsuda_masayuki@example.com	大阪府
小町 亮	komachi_ryou@example.com	静岡県
高島 豊	takashima_yutaka@example.com	福岡県
土居 丈雄	doi_takeo@example.com	大阪府
黒川 由樹	kurokawa_yuki@example.com	熊本県
川畑 砂羽	kawahata_sawa@example.com	東京都
古屋 拓郎	furuya_takurou@example.com	大分県
宮川 砂羽	miyakawa_sawa@example.com	群馬県
上山 優	kamiyama_yuu1@example.com	岩手県
瀬戸 淳	seto_atsushi@example.com	静岡県
石橋 俊介	ishibashi_shunsuke@example.com	静岡県
横田 利夫	yokota_toshio@example.com	愛知県
宮里 利夫	miyazato_toshio@example.com	北海道
高井 輝信	takai_akinobu@example.com	和歌山県
柳 涼子	yanagi_ryouko@example.com	神奈川県
仲田 なつみ	nakata_natsumi@example.com	東京都
藤原 恭子	fujiwara_kyouko@example.com	宮崎県
宇佐美 三省	usami_sansei@example.com	千葉県
広瀬 遥	hirose_haruka@example.com	京都府
岸 はるみ	kishi_harumi@example.com	東京都
内野 ひろ子	uchino_hiroko@example.com	北海道
大友 寿々花	ootomo_suzuka@example.com	東京都
菅井 崇史	sugai_takashi@example.com	新潟県
谷本 コウ	tanimoto_kou@example.com	京都府
役所 扶樹	yakusho_motoki@example.com	神奈川県
島袋 遥	shimabukuro_haruka@example.com	茨城県
寺井 新太	terai_arata@example.com	群馬県
田辺 淳	tanabe_atsushi@example.com	茨城県
岩井 ひろみ	iwai_hiromi@example.com	茨城県
大津 恭子	ootsu_kyouko@example.com	愛知県
西原 めぐみ	nishihara_megumi@example.com	福島県
矢野 はるみ	yano_harumi@example.com	岐阜県
青山 敏也	aoyama_toshiya@example.com	北海道
中 七世	naka_nanase@example.com	北海道
熊倉 美菜	kumakura_mina@example.com	茨城県
橘 春樹	tachibana_haruki1@example.com	大阪府
田原 まなみ	tahara_manami@example.com	兵庫県
岡本 まなみ	okamoto_manami@example.com	大阪府
白木 美里	shiraki_miri@example.com	広島県
関根 由宇	sekine_yuu@example.com	長野県
植田 完爾	ueta_kanji@example.com	東京都
坂井 綾女	sakai_ayame@example.com	東京都
上村 春樹	uemura_haruki@example.com	新潟県
浅野 しぼり	asano_shibori@example.com	神奈川県
役所 和之	yakusho_kazuyuki@example.com	東京都
八田 克実	yatsuda_katsumi@example.com	京都府
長友 翔子	nagatomo_shouko@example.com	山形県
日野 みあ	hino_mia@example.com	山形県
橘 雅之	tachibana_masayuki@example.com	鹿児島県
清水 あさみ	shimizu_asami@example.com	埼玉県
芳賀 かおり	haga_kaori@example.com	東京都
北田 小百合	kitada_sayuri@example.com	静岡県
蛍原 千佳子	hotohara_chikako@example.com	岡山県
古屋 剛基	furuya_yoshiki@example.com	岩手県
土居 美和子	doi_miwako@example.com	広島県
伊藤 啓介	itou_keisuke@example.com	神奈川県
宇田川 あき	udagawa_aki@example.com	千葉県
中林 奈月	nakabayashi_natsuki@example.com	青森県
島津 光臣	shimadu_mitsuomi@example.com	大阪府
勝又 サダヲ	katsumata_sadawo@example.com	愛知県
水谷 しほり	mizutani_shihori@example.com	島根県
飯田 結衣	iida_yui@example.com	神奈川県
村田 建	murata_ken@example.com	愛知県
成田 蒼甫	narita_sousuke@example.com	東京都
山口 さんま	yamaguchi_sanma@example.com	群馬県
大城 花	ooshiro_hana@example.com	福島県
大坪 英嗣	ootsubo_hidetsugu@example.com	愛知県
早川 蒼甫	hayakawa_sousuke@example.com	愛知県
浅見 碧海	asami_ouga@example.com	兵庫県
森島 完爾	morishima_kanji@example.com	大阪府
門田 なつみ	kadota_natsumi@example.com	千葉県
若槻 美希	wakatsuki_miki@example.com	愛知県
高谷 由宇	takaya_yuu@example.com	鹿児島県
菊池 博明	kikuchi_hiroaki@example.com	静岡県
高樹 路子	takagi_michiko@example.com	北海道
市川 三省	ichikawa_sansei@example.com	奈良県
吉野 ちえみ	yoshino_chiemi@example.com	東京都
三島 努	mishima_tsutomu@example.com	千葉県
小玉 仁	kodama_jin@example.com	広島県
中川 三省	nakagawa_sansei@example.com	香川県
磯村 倫子	isomura_noriko@example.com	静岡県
三島 丈史	mishima_takeshi@example.com	富山県
古田 憲史	furuta_norihito@example.com	福岡県
玉木 ひろみ	tamaki_hiromi@example.com	神奈川県
西口 隆之介	nishiguchi_ryuunosuke@example.com	東京都
瀬戸 努	seto_tsutomu@example.com	熊本県
長友 一代	nagatomo_kazuyo@example.com	沖縄県
宮田 かおり	miyata_kaori@example.com	長崎県
小池 碧海	koike_ouga@example.com	三重県
橘 陽子	tachibana_youko@example.com	大分県
落合 サダヲ	ochiai_sadawo@example.com	愛知県
池田 遥	ikeda_haruka@example.com	千葉県
今川 功補	imagawa_kousuke@example.com	山梨県
神保 信吾	jinbo_shingo@example.com	大阪府
出口 勝久	deguchi_katsuhisa@example.com	富山県
有賀 由宇	ariga_yuu@example.com	大阪府
若杉 ヒカル	wakasugi_hikaru@example.com	熊本県
那須 大樹	nasu_hiroki@example.com	福岡県
柴田 小雁	shibata_kogan@example.com	福島県
堀口 花	horiguchi_hana@example.com	岩手県
武藤 法子	mutou_noriko@example.com	茨城県
堀田 由宇	hotta_yuu@example.com	新潟県
田村 竜也	tamura_tatsuya1@example.com	京都府
内田 璃奈子	uchida_rinako@example.com	東京都
川原 りえ	kawahara_rie1@example.com	北海道
小田 俊介	oda_shunsuke@example.com	富山県
藤原 信輔	fujiwara_shinsuke@example.com	大分県
江崎 研二	ezaki_kenji@example.com	兵庫県
森谷 あや子	moriya_ayako@example.com	香川県
立川 七世	tachikawa_nanase@example.com	東京都
秋本 あさみ	akimoto_asami@example.com	神奈川県
荒木 大	araki_masaru@example.com	岡山県
朝倉 遥	asakura_haruka@example.com	大阪府
高野 ひろ子	takano_hiroko@example.com	神奈川県
とよた 努	toyota_tsutomu@example.com	新潟県
松下 愛菜	matsushita_aina@example.com	栃木県
池内 ジローラモ	ikeuchi_girolamo@example.com	長崎県
三浦 由宇	miura_yuu@example.com	神奈川県
水谷 瞳	mizutani_hitomi@example.com	愛知県
小沼 恵子	konuma_keiko1@example.com	埼玉県
宇田川 研二	udagawa_kenji@example.com	東京都
富永 仁	tominaga_jin@example.com	福井県
久野 長利	hisano_nagatoshi@example.com	東京都
神木 将也	kamiki_masaya@example.com	広島県
笹原 雅彦	sasahara_masahiko@example.com	宮崎県
早美 俊介	hayami_shunsuke@example.com	京都府
市田 功補	ichida_kousuke@example.com	長崎県
高梨 樹里	takanashi_juri@example.com	東京都
有田 紗季	arita_saki@example.com	兵庫県
千田 みゆき	sennda_miyuki@example.com	愛知県
塩田 真悠子	shiota_mayuko@example.com	埼玉県
滝口 恵麻	takiguchi_ema@example.com	東京都
小松 優	komatsu_yuu@example.com	東京都
海音寺 怜奈	kaionji_reina@example.com	長崎県
大城 璃奈子	ooshiro_rinako@example.com	群馬県
玉山 信輔	tamayama_shinsuke@example.com	群馬県
杉本 鉄洋	sugimoto_tetsuhiro@example.com	埼玉県
林 将也	hayashi_masaya@example.com	兵庫県
川畑 誠治	kawahata_seiji@example.com	佐賀県
貫地谷 博之	kanjiya_hiroyuki@example.com	東京都
村木 和香	muraki_waka@example.com	千葉県
今 夏希	kon_natsuki@example.com	大阪府
風間 聖陽	kazama_masaaki@example.com	東京都
天野 勇	amano_yuu@example.com	群馬県
江口 法嗣	eguchi_houshi@example.com	大阪府
小高 賢二	kodaka_kenji@example.com	愛知県
工藤 高史	kudou_takashi@example.com	福島県
菊池 哲平	kikuchi_teppei@example.com	山口県
安 恵美	yasu_megumi@example.com	秋田県
北田 貴嶺	kitada_takane@example.com	長崎県
相武 陽子	aibu_youko@example.com	神奈川県
細野 憲史	hosono_norihito@example.com	福岡県
守屋 恭子	moriya_kyouko@example.com	千葉県
浅野 瑠璃亜	asano_ruria@example.com	兵庫県
白井 美幸	shirai_miyuki@example.com	富山県
菅澤 洋	sugasawa_you@example.com	東京都
波多野 守	hatano_mamoru@example.com	石川県
高嶋 恵梨香	takashima_erika@example.com	山形県
今 ひかり	ima_hikari@example.com	愛知県
米倉 和久	yonekura_kazuhisa@example.com	大阪府
山崎 景子	yamazaki_keiko@example.com	岐阜県
内藤 まみ	naitou_mami@example.com	京都府
森本 聡	morimoto_satoshi@example.com	大阪府
園田 菜々美	sonoda_nanami@example.com	滋賀県
宮里 美優	miyazato_myuu@example.com	静岡県
湯浅 早織	yuasa_saori@example.com	神奈川県
長尾 美嘉	nagao_mika@example.com	香川県
丸田 雅彦	maruta_masahiko@example.com	愛媛県
大崎 雅彦	oosaki_masahiko@example.com	栃木県
佐藤 璃子	satou_riko@example.com	北海道
生田 さやか	namata_sayaka@example.com	北海道
古賀 景子	koga_keiko@example.com	茨城県
宮原 ヒロ	miyahara_hiro@example.com	神奈川県
矢部 光博	yabe_mitsuhiro@example.com	大阪府
島津 美幸	shimadu_miyuki1@example.com	大阪府
秋田 雅之	akita_masayuki@example.com	東京都
尾崎 夏希	ozaki_natsuki@example.com	宮崎県
佐竹 ひとり	satake_hitori@example.com	埼玉県
三上 めぐみ	mikami_megumi@example.com	熊本県
安藤 寿々花	anndou_suzuka@example.com	千葉県
末永 翔	suenaga_shou@example.com	東京都
横井 進	yokoi_susumu@example.com	大阪府
青山 美佐子	aoyama_misako@example.com	大阪府
橘 倫子	tachibana_noriko@example.com	兵庫県
本橋 祐一	motohashi_yuuichi@example.com	福島県
杉山 晴臣	sugiyama_haruomi@example.com	茨城県
柴山 勝久	shibayama_katsuhisa@example.com	愛知県
金子 有海	kaneko_ami@example.com	大阪府
黒木 郁恵	kuroki_ikue@example.com	東京都
片山 ケンイチ	katayama_kenichi@example.com	愛知県
武田 里穂	takeda_riho@example.com	福島県
益田 六郎	masuda_rokurou@example.com	愛知県
西川 大五郎	nishikawa_daigorou@example.com	福岡県
白石 芽以	shiraishi_mei@example.com	大阪府
小林 夏希	kobayashi_natsuki@example.com	石川県
工藤 将也	kudou_masaya@example.com	愛知県
西本 恵美	nishimoto_megumi@example.com	佐賀県
豊島 博之	toyoshima_hiroyuki@example.com	愛媛県
米田 真吾	yoneda_shingo@example.com	大阪府
西沢 沙耶	nishizawa_saya@example.com	福島県
大下 完爾	ooshita_kanji@example.com	神奈川県
守屋 隆之介	moriya_ryuunosuke@example.com	三重県
河原 友也	kawahara_tomoya@example.com	愛知県
門田 恵麻	kadota_ema@example.com	長崎県
内田 研二	uchida_kenji@example.com	北海道
新垣 雅彦	niigaki_masahiko@example.com	福岡県
菅澤 茜	sugasawa_akane@example.com	大阪府
玉木 法子	tamaki_noriko@example.com	三重県
余 佑	yo_tasuku@example.com	鹿児島県
水嶋 直人	mizushima_naoto@example.com	熊本県
奥山 さとみ	okuyama_satomi@example.com	埼玉県
土橋 きみまろ	tsuchihashi_kimimaro@example.com	徳島県
白石 満	shiraishi_mitsuru@example.com	群馬県
森川 未來	morikawa_mirai@example.com	徳島県
若林 直人	wakabayashi_naoto@example.com	京都府
三島 早紀	mishima_saki@example.com	広島県
吉田 和香	yoshida_waka@example.com	北海道
伊崎 恵望子	isaki_emiko@example.com	愛知県
三田 怜奈	mita_reina@example.com	静岡県
北山 恵子	kitayama_keiko@example.com	福岡県
塚田 亮	tsukada_ryou@example.com	愛媛県
筧 栄一	kakei_eiichi@example.com	神奈川県
相川 千佳子	aikawa_chikako@example.com	香川県
寺本 知世	teramoto_chise@example.com	大阪府
米谷 薫	yoneya_kaoru@example.com	石川県
竹田 憲一	takeda_kenichi@example.com	岐阜県
太田 英嗣	oota_hidetsugu@example.com	神奈川県
上田 長利	ueda_nagatoshi@example.com	大阪府
浜野 美帆	hamano_miho@example.com	静岡県
河野 一代	kouno_kazuyo@example.com	東京都
津田 美幸	tsuda_miyuki@example.com	兵庫県
高山 ノブヒコ	takayama_nobuhiko@example.com	愛知県
木本 建	kimoto_ken@example.com	静岡県
三浦 ジローラモ	miura_girolamo@example.com	香川県
中根 さゆり	nakane_sayuri@example.com	大阪府
小泉 徹	koizumi_tooru@example.com	埼玉県
浅川 美佳	asakawa_mika@example.com	京都府
小川 勇太	ogawa_yuuta@example.com	北海道
平良 康文	hirara_yasufumi@example.com	福岡県
長野 満	nagano_mitsuru@example.com	熊本県
井川 詩織	igawa_shiori@example.com	兵庫県
川畑 花	kawahata_hana@example.com	大阪府
村瀬 莉緒	murase_rio@example.com	福岡県
岡 和香	oka_waka@example.com	三重県
森脇 陽子	moriwaki_youko@example.com	愛知県
益田 徹	masuda_tooru@example.com	東京都
早川 仁晶	hayakawa_hiroaki@example.com	北海道
横川 莉沙	yokokawa_risa@example.com	神奈川県
金森 ジョージ	kanamori_george@example.com	埼玉県
羽田 遥	hada_haruka@example.com	広島県
大庭 陽子	ooniwa_youko@example.com	茨城県
大井 兼	ooi_ken@example.com	静岡県
武内 明日	takeuchi_meibi@example.com	千葉県
田中 亜希	tanaka_aki@example.com	愛知県
小田 れいな	oda_reina@example.com	愛知県
六角 光臣	rokkaku_mitsuomi@example.com	福岡県
内山 美嘉	uchiyama_mika@example.com	埼玉県
中沢 季衣	nakazawa_toshie@example.com	山口県
横井 里奈	yokoi_rina@example.com	埼玉県
丸山 はるか	maruyama_haruka@example.com	東京都
喜多 雅之	kita_masayuki@example.com	島根県
神崎 エリカ	kannzaki_erika@example.com	神奈川県
長友 太朗	nagatomo_tarou1@example.com	栃木県
下山 愛子	shimoyama_aiko@example.com	愛媛県
小木 勇太	ogi_yuuta@example.com	神奈川県
星 真一	hoshi_shinichi@example.com	東京都
相武 一樹	aibu_kazuki@example.com	福岡県
栗山 瑠璃亜	kuriyama_ruria@example.com	東京都
菊田 由美子	kikuta_yumiko@example.com	宮城県
山内 希	yamauchi_nozomi@example.com	栃木県
古川 知世	furukawa_chise@example.com	兵庫県
立花 まさみ	tachibana_masami1@example.com	東京都
高畑 光臣	takabata_mitsuomi@example.com	兵庫県
勝又 希	katsumata_nozomi@example.com	北海道
早坂 鉄洋	hayasaka_tetsuhiro@example.com	長野県
畑中 亜希	hatanaka_aki@example.com	広島県
藤木 まみ	fujiki_mami@example.com	埼玉県
白鳥 鉄二	shiratori_tetsuji@example.com	京都府
西口 サンタマリア	nishiguchi_stmaria@example.com	兵庫県
北条 涼	houjou_ryou@example.com	茨城県
宮里 完爾	miyazato_kanji@example.com	愛媛県
岡本 千夏	okamoto_chinatsu@example.com	岐阜県
鎌田 あさみ	kamata_asami@example.com	千葉県
森永 れいな	morinaga_reina@example.com	神奈川県
辻本 亮	tsujimoto_ryou@example.com	宮崎県
岩間 雅彦	iwama_masahiko@example.com	神奈川県
益岡 亮介	masuoka_ryousuke@example.com	沖縄県
野上 寛	nogami_hiroshi@example.com	兵庫県
手塚 そら	teduka_sora@example.com	福岡県
浅見 克実	asami_katsumi@example.com	埼玉県
広末 瑠璃亜	hirosue_ruria@example.com	長野県
大滝 沙耶	ootaki_saya@example.com	埼玉県
山野 愛梨	yamano_airi@example.com	広島県
戸塚 徹	toduka_tooru@example.com	福岡県
青山 裕司	aoyama_yuuji@example.com	愛知県
平塚 麻由子	hiratsuka_mayuko@example.com	東京都
清野 礼子	kiyono_reiko@example.com	愛媛県
磯村 和久	isomura_kazuhisa@example.com	千葉県
瀬戸内 妃里	setouchi_yuri@example.com	富山県
大友 惇	ootomo_jun@example.com	愛知県
富永 優	tominaga_yuu@example.com	静岡県
野口 涼子	noguchi_ryouko@example.com	愛知県
安斎 洋介	annzai_yousuke@example.com	茨城県
岸部 ひとり	kishibe_hitori@example.com	北海道
内野 賢治	uchino_kenji@example.com	福島県
菊田 美幸	kikuta_miyuki@example.com	広島県
椎名 直人	shiina_naoto@example.com	福岡県
市川 進	ichikawa_susumu@example.com	山梨県
吉岡 幸子	yoshioka_sachiko@example.com	愛知県
今村 恵子	imamura_keiko@example.com	青森県
早美 俊二	hayami_shunji@example.com	福島県
熊井 英嗣	kumai_hidetsugu@example.com	東京都
土田 英嗣	tsuchida_hidetsugu@example.com	香川県
筧 有起哉	kakei_yukiya1@example.com	大阪府
村田 菜々美	murata_nanami@example.com	大阪府
石倉 ひろみ	ishikura_hiromi@example.com	茨城県
野島 美月	nojima_miduki@example.com	大阪府
宮田 はるみ	miyata_harumi@example.com	神奈川県
福永 勇	fukunaga_yuu@example.com	三重県
清野 寿明	kiyono_toshiaki@example.com	神奈川県
寺本 洋介	teramoto_yousuke@example.com	福岡県
石野 勇介	ishino_yuusuke@example.com	三重県
上原 薫	uehara_kaoru@example.com	愛知県
日下部 美菜	kusakabe_mina@example.com	福岡県
貫地谷 公顕	kanjiya_kimiaki@example.com	神奈川県
遠山 南朋	tooyama_nao@example.com	新潟県
楠本 しぼり	kusumoto_shibori@example.com	広島県
川添 美月	kawazoe_miduki@example.com	埼玉県
野呂 遥	noro_haruka@example.com	宮崎県
西村 一代	nishimura_kazuyo@example.com	大阪府
川辺 利夫	kawabe_toshio@example.com	北海道
柴田 薫	shibata_kaoru@example.com	新潟県
金城 あい	kanashiro_ai@example.com	愛知県
安部 詩織	abe_shiori@example.com	岡山県
片瀬 瞬	katase_shun1@example.com	神奈川県
豊田 米蔵	toyota_yonezou@example.com	埼玉県
三橋 メイサ	mihashi_meisa@example.com	東京都
堀川 れいな	horikawa_reina@example.com	富山県
早美 仁晶	hayami_hiroaki@example.com	静岡県
大倉 恵子	ookura_keiko@example.com	兵庫県
内田 景子	uchida_keiko@example.com	岡山県
一青 郁恵	hitoto_ikue@example.com	愛知県
井川 優	igawa_yuu1@example.com	長崎県
増田 倫子	masuda_noriko@example.com	山梨県
白木 しぼり	shiraki_shibori@example.com	兵庫県
細谷 あき	hosoya_aki@example.com	群馬県
沢田 隆之介	sawada_ryuunosuke@example.com	神奈川県
小椋 徹平	ogura_teppei@example.com	北海道
五十嵐 勤	igarashi_tsutomu@example.com	埼玉県
古谷 恵梨香	furutani_erika@example.com	北海道
金児 季衣	kaneko_toshie@example.com	大阪府
細山 英嗣	hosoyama_hidetsugu@example.com	神奈川県
加瀬 真帆	kase_maho@example.com	岡山県
白石 めぐみ	shiraishi_megumi@example.com	大阪府
少路 建	shouji_ken@example.com	愛知県
宇都宮 公顕	utsunomiya_kimiaki@example.com	長崎県
池内 亮	ikeuchi_ryou@example.com	東京都
相田 だん吉	aida_dankichi@example.com	高知県
田所 たまき	tadokoro_tamaki@example.com	富山県
岡本 美希	okamoto_miki@example.com	愛知県
太田 ケンイチ	oota_kenichi@example.com	千葉県
小口 奈央	oguchi_nao@example.com	沖縄県
窪塚 広司	kuboduka_kouji1@example.com	埼玉県
下川 剛基	shimokawa_yoshiki@example.com	福岡県
堀内 薫	horiuchi_kaoru@example.com	富山県
楠本 美幸	kusumoto_miyuki@example.com	千葉県
緒方 蒼甫	ogata_sousuke@example.com	千葉県
横田 玲那	yokota_rena@example.com	千葉県
平賀 聡	hiraga_satoshi@example.com	北海道
小室 誠治	komuro_seiji@example.com	石川県
清田 さとみ	kiyota_satomi@example.com	神奈川県
大木 瞳	ooki_hitomi@example.com	和歌山県
磯部 大樹	isobe_hiroki@example.com	岡山県
沖 杏	oki_ann@example.com	東京都
金山 綾女	kanayama_ayame@example.com	奈良県
小林 真悠子	kobayashi_mayuko@example.com	北海道
牧野 光良	makino_teruyoshi@example.com	大阪府
風間 直人	kazama_naoto@example.com	千葉県
金城 あさみ	kanashiro_asami@example.com	茨城県
沢 草太	sawa_souta@example.com	埼玉県
市川 聖陽	ichikawa_masaaki@example.com	千葉県
三井 晃司	mitsui_kouji@example.com	東京都
金田 たまき	kaneda_tamaki@example.com	長野県
増井 秀隆	masui_hidetaka@example.com	大阪府
柳 由宇	yanagi_yuu@example.com	福岡県
大林 育子	oobayashi_ikuko@example.com	東京都
広川 景子	hirokawa_keiko@example.com	東京都
加藤 将也	katou_masaya@example.com	埼玉県
長崎 景子	nagasaki_keiko@example.com	埼玉県
金山 美里	kanayama_miri@example.com	神奈川県
吉崎 丈雄	yoshizaki_takeo@example.com	香川県
北原 美帆	kitahara_miho@example.com	神奈川県
足立 薫	adachi_kaoru@example.com	東京都
木下 麻由子	kinoshita_mayuko@example.com	北海道
林 あい	hayashi_ai@example.com	愛知県
榊原 かおり	sakakibara_kaori@example.com	神奈川県
三村 友以乃	mimura_yuino@example.com	神奈川県
武内 綾	takeuchi_aya@example.com	長崎県
柏木 咲	kashiwagi_saki@example.com	神奈川県
小原 有起哉	ohara_yukiya@example.com	兵庫県
河村 宏行	kawamura_hiroyuki@example.com	岐阜県
松永 一恵	matsunaga_kadue@example.com	京都府
高尾 徹平	takao_teppei@example.com	埼玉県
高瀬 美咲	takase_misaki@example.com	新潟県
千田 恵子	sennda_keiko@example.com	長野県
大川 翔太	ookawa_shouta@example.com	千葉県
柴咲 さとみ	shibasaki_satomi@example.com	神奈川県
志賀 隆博	shiga_takahiro@example.com	広島県
黒沢 俊二	kurosawa_shunji@example.com	宮崎県
葛西 和香	kasai_waka@example.com	東京都
中川 正義	nakagawa_masayoshi@example.com	奈良県
白石 美希	shiraishi_miki@example.com	東京都
泉 三省	izumi_sansei@example.com	兵庫県
五十嵐 徹	igarashi_tohru@example.com	神奈川県
古田 さとみ	furuta_satomi@example.com	茨城県
田辺 精児	tanabe_seiji@example.com	山梨県
石黒 遥	ishiguro_haruka@example.com	東京都
片平 恵麻	katahira_ema@example.com	香川県
安藤 正敏	ando_masatoshi@example.com	福岡県
堤 淳子	tsutsumi_atsuko1@example.com	山梨県
松居 なつみ	matsui_natsumi1@example.com	秋田県
手島 まみ	tejima_mami@example.com	長野県
坂野 浩太郎	itano_koutarou@example.com	広島県
福士 鉄二	fukushi_tetsuji@example.com	千葉県
泉 美佐子	izumi_misako@example.com	神奈川県
荒木 みゆき	araki_miyuki@example.com	東京都
藤 浩太郎	fuji_koutarou@example.com	福岡県
北沢 ヒロ	kitazawa_hiro@example.com	神奈川県
二宮 サンタマリア	ninomiya_stmaria@example.com	宮崎県
内田 和久	uchida_kazuhisa@example.com	東京都
中原 法子	nakahara_noriko@example.com	新潟県
中山 祐一	nakayama_yuuichi@example.com	新潟県
花田 りえ	hanada_rie@example.com	東京都
藤島 みゆき	fujishima_miyuki@example.com	山形県
大地 恵子	oochi_keiko@example.com	大阪府
大熊 りえ	ookuma_rie@example.com	福島県
日高 早織	hidaka_saori@example.com	東京都
阿部 遥	abe_haruka@example.com	愛知県
原田 美和子	harada_miwako@example.com	東京都
佐々木 有海	sasaki_ami@example.com	茨城県
西島 恭子	nishijima_kyouko@example.com	福岡県
安部 晋也	abe_shinya@example.com	神奈川県
飯野 めぐみ	iino_megumi@example.com	千葉県
西野 だん吉	nishino_dankichi@example.com	大阪府
伴 美菜	ban_mina@example.com	千葉県
曽我 菜摘	soga_natsumi@example.com	東京都
浜本 恭子	hamamoto_kyouko@example.com	滋賀県
福本 勇介	fukumoto_yuusuke@example.com	三重県
相原 陽子	aihara_youko@example.com	熊本県
星 基祐	hoshi_kisuke@example.com	福岡県
黒川 みゆき	kurokawa_miyuki@example.com	長崎県
佐川 研二	sagawa_kenji@example.com	東京都
宮崎 竜也	miyazaki_tatsuya@example.com	東京都
大和田 明	oowada_akira@example.com	栃木県
稲田 恭子	inada_kyouko@example.com	埼玉県
城咲 竜也	shirosaki_tatsuya@example.com	東京都
田原 美佐子	tahara_misako@example.com	東京都
島本 蒼甫	shimamoto_sousuke@example.com	栃木県
風間 寿々花	kazama_suzuka@example.com	大阪府
桜井 なぎさ	sakurai_nagisa@example.com	愛知県
石井 理紗	ishii_risa@example.com	和歌山県
有馬 佳乃	arima_yoshino@example.com	愛知県
松下 良介	matsushita_ryousuke@example.com	大阪府
鹿手袋 恵子	shikatebukuro_keiko@example.com	茨城県
妻夫木 貴美子	tsumabuki_kimiko@example.com	栃木県
内野 有海	uchino_ami@example.com	山口県
長野 慶二	nagano_keiji@example.com	宮崎県
塩見 明	shiomi_akira@example.com	福岡県
伊集院 菜々美	ijuuin_nanami@example.com	千葉県
三井 俊二	mitsui_shunji@example.com	愛媛県
寺本 隆之介	teramoto_ryuunosuke@example.com	愛知県
大庭 聡	ooniwa_satoshi@example.com	埼玉県
安井 さとみ	yasui_satomi@example.com	青森県
中尾 直人	nakao_naoto@example.com	大阪府
萩原 真帆	hagiwara_maho@example.com	福岡県
川上 大五郎	kawakami_daigorou@example.com	埼玉県
武内 愛梨	takeuchi_airi@example.com	岐阜県
岩永 ヒロ	iwanaga_hiro@example.com	千葉県
小口 桃子	oguchi_momoko@example.com	愛媛県
近藤 満	konndou_mitsuru@example.com	鹿児島県
河野 真一	kawano_shinichi@example.com	長野県
斉藤 雄太	saitou_yuuta@example.com	兵庫県
阪本 莉央	sakamoto_rio@example.com	埼玉県
正木 一	masaki_hajime@example.com	東京都
川田 文世	kawata_fumiyo@example.com	東京都
井田 あい	ida_ai1@example.com	静岡県
児島 丈雄	kojima_takeo@example.com	群馬県
小原 窈	ohara_you@example.com	東京都
河村 照生	kawamura_teruo@example.com	熊本県
深谷 将也	fukaya_masaya@example.com	神奈川県
谷本 くるみ	tanimoto_kurumi@example.com	東京都
長浜 精児	nagahama_seiji@example.com	神奈川県
福士 さんま	fukushi_sanma@example.com	茨城県
皆川 未來	minakawa_mirai@example.com	東京都
阿部 美幸	abe_miyuki@example.com	神奈川県
石田 ヒカル	ishida_hikaru@example.com	山梨県
乾 三省	inui_sansei@example.com	大阪府
児玉 誠一	kodama_seiichi@example.com	埼玉県
山中 ジローラモ	yamanaka_girolamo@example.com	福島県
藤森 光博	fujimori_mitsuhiro@example.com	千葉県
多田 彩華	tada_ayaka@example.com	石川県
高尾 美里	takao_miri@example.com	神奈川県
吉本 美佐子	yoshimoto_misako@example.com	京都府
桑原 六郎	kuwabara_rokurou@example.com	新潟県
柴田 紗季	shibata_saki@example.com	広島県
横山 育二	yokoyama_ikuji@example.com	愛知県
妻夫木 広司	tsumabuki_kouji@example.com	愛知県
那須 沙耶	nasu_saya@example.com	東京都
長田 光	nagata_hikaru@example.com	高知県
吉原 一恵	yoshiwara_kadue@example.com	愛媛県
吉野 祐一	yoshino_yuuichi@example.com	千葉県
鳥居 路子	torii_michiko@example.com	千葉県
杉本 ひかり	sugimoto_hikari@example.com	大阪府
長岡 なつみ	nagaoka_natsumi@example.com	岩手県
村上 優	murakami_yuu1@example.com	東京都
真田 桃子	sanada_momoko@example.com	千葉県
大沢 恵梨香	oosawa_erika@example.com	滋賀県
坂野 洋介	itano_yousuke@example.com	北海道
内村 洋	uchimura_you@example.com	愛知県
梶原 京子	kajiwara_kyouko@example.com	埼玉県
広川 奈月	hirokawa_natsuki@example.com	奈良県
米田 栄一	yoneda_eiichi@example.com	宮城県
梅原 亮	umehara_ryou@example.com	北海道
奈良 憲一	nara_kenichi@example.com	静岡県
森井 ひろみ	morii_hiromi@example.com	茨城県
浅井 美佐子	asai_misako@example.com	静岡県
中里 悟志	nakazato_satoshi@example.com	大阪府
三橋 彩華	mihashi_ayaka@example.com	東京都
桑田 莉緒	kuwata_rio1@example.com	愛知県
高沢 友香	takasawa_tomoka@example.com	東京都
岩井 なつみ	iwai_natsumi@example.com	大阪府
青山 結衣	aoyama_yui@example.com	愛知県
小平 明宏	kohira_akihiro@example.com	東京都
浅見 彩華	asami_ayaka@example.com	群馬県
志村 哲平	shimura_teppei@example.com	東京都
田村 璃奈子	tamura_rinako@example.com	福岡県
福島 美菜	fukushima_mina@example.com	大阪府
柴田 まなみ	shibata_manami@example.com	京都府
篠田 結衣	shinoda_yui@example.com	高知県
千田 砂羽	sennda_sawa@example.com	徳島県
岡田 美紀	okada_miki@example.com	岡山県
吉岡 英嗣	yoshioka_hidetsugu@example.com	神奈川県
平山 勇一	hirayama_yuuichi@example.com	鳥取県
生瀬 郁恵	namase_ikue@example.com	石川県
楠 理紗	kusunoki_risa@example.com	愛知県
米田 美菜	yoneda_mina@example.com	鹿児島県
志水 美佐	shimizu_misa@example.com	千葉県
古田 恵麻	furuta_ema@example.com	大阪府
岩永 将也	iwanaga_masaya@example.com	新潟県
川村 綾女	kawamura_ayame@example.com	徳島県
広川 誠治	hirokawa_seiji@example.com	熊本県
多岐川 みあ	takigawa_mia@example.com	東京都
酒井 禄郎	sakai_rokurou@example.com	神奈川県
萩原 遥	hagiwara_haruka@example.com	静岡県
前原 幸平	maehara_kouhei@example.com	東京都
中根 隼士	nakane_shunji@example.com	福島県
笠原 那奈	kasahara_nana@example.com	東京都
福士 ひとみ	fukushi_hitomi@example.com	千葉県
浜 勤	hama_tsutomu@example.com	北海道
永瀬 きみまろ	nagase_kimimaro@example.com	佐賀県
矢島 和香	yajima_waka@example.com	埼玉県
市村 寛治	ichimura_kanji@example.com	愛知県
唐沢 浩介	karasawa_kousuke@example.com	愛媛県
大谷 美咲	ootani_misaki@example.com	静岡県
小木 あき	ogi_aki@example.com	佐賀県
堀 慎之介	hori_shinnosuke@example.com	鹿児島県
深井 華子	fukai_hanako@example.com	新潟県
黒崎 愛子	kurosaki_aiko@example.com	広島県
小菅 公顕	kosuge_kimiaki@example.com	香川県
飯野 孝太郎	iino_koutarou@example.com	石川県
落合 明	ochiai_akira@example.com	秋田県
小山 一	oyama_hajime@example.com	宮城県
細田 涼子	hosoda_ryouko@example.com	静岡県
松澤 真悠子	matsuzawa_mayuko1@example.com	長崎県
河原 広之	kawahara_hiroyuki@example.com	兵庫県
日野 雅之	hino_masayuki@example.com	群馬県
矢作 隼士	yahagi_shunji@example.com	東京都
倉本 里奈	kuramoto_rina@example.com	東京都
川原 博之	kawahara_hiroyuki1@example.com	東京都
板橋 広之	itabashi_hiroyuki@example.com	熊本県
荻原 怜奈	hagiwara_reina@example.com	千葉県
藤野 れいな	fujino_reina@example.com	沖縄県
横川 友香	yokokawa_tomoka@example.com	新潟県
水島 紗季	mizushima_saki@example.com	栃木県
伊丹 美和子	itami_miwako@example.com	東京都
北島 さゆり	kitajima_sayuri@example.com	長野県
仲村 涼子	nakamura_ryouko@example.com	北海道
磯野 基祐	isono_kisuke@example.com	埼玉県
市村 真悠子	ichimura_mayuko@example.com	新潟県
大野 法嗣	oono_houshi@example.com	埼玉県
田代 薫	tashiro_kaoru@example.com	福島県
松田 完爾	matsuda_kanji@example.com	東京都
新垣 しぼり	aragaki_shibori@example.com	福岡県
井上 俊二	inoue_shunji@example.com	岩手県
田尻 勤	tajiri_tsutomu@example.com	静岡県
岩佐 華子	iwasa_hanako@example.com	佐賀県
平良 優	hirara_yuu@example.com	神奈川県
森山 雅彦	moriyama_masahiko@example.com	鹿児島県
塩谷 礼子	shioya_reiko@example.com	三重県
小高 涼子	kodaka_ryouko@example.com	神奈川県
島 あさみ	shima_asami@example.com	千葉県
野沢 みき	nozawa_miki@example.com	東京都
岡本 マサカズ	okamoto_masakazu@example.com	福岡県
高松 さとみ	takamatsu_satomi@example.com	東京都
長谷川 結子	hasegawa_yuuko@example.com	鹿児島県
吉本 三省	yoshimoto_sansei@example.com	岐阜県
横山 美幸	yokoyama_miyuki@example.com	千葉県
金森 寛治	kanamori_kanji@example.com	埼玉県
五十嵐 ひろ子	igarashi_hiroko@example.com	富山県
島崎 れいな	shimazaki_reina@example.com	高知県
山川 仁	yamakawa_jin@example.com	滋賀県
西原 たかお	nishihara_takao@example.com	神奈川県
さだ 明宏	sada_akihiro@example.com	長野県
楠 育二	kusunoki_ikuji@example.com	東京都
岡田 美佳	okada_mika@example.com	熊本県
吉永 隆	yoshinaga_takashi@example.com	宮崎県
高田 明	takada_akira@example.com	福島県
橋爪 美幸	hashidume_miyuki@example.com	東京都
平山 陽子	hirayama_youko@example.com	宮城県
戸塚 涼	toduka_ryou@example.com	北海道
藤田 賢治	fujita_kenji@example.com	富山県
千葉 莉央	chiba_rio@example.com	千葉県
井本 そら	imoto_sora@example.com	大阪府
古賀 璃奈子	koga_rinako@example.com	三重県
酒井 新太	sakai_arata@example.com	三重県
諏訪 法嗣	suwa_houshi@example.com	長野県
花岡 樹里	hanaoka_juri@example.com	徳島県
柴崎 結子	shibazaki_yuuko@example.com	滋賀県
益岡 崇史	masuoka_takashi@example.com	神奈川県
小松 陽介	komatsu_yousuke@example.com	東京都
高梨 弘也	takanashi_hironari@example.com	京都府
大井 栄一	ooi_eiichi@example.com	兵庫県
森山 基祐	moriyama_kisuke@example.com	埼玉県
諏訪 文世	suwa_fumiyo@example.com	高知県
日下 ひかり	hinoshita_hikari@example.com	鳥取県
北条 仁晶	houjou_hiroaki@example.com	神奈川県
倉田 遥	kurata_haruka@example.com	静岡県
岡 誠一	oka_seiichi@example.com	大阪府
小笠原 結子	ogasawara_yuuko@example.com	神奈川県
石本 碧海	ishimoto_ouga@example.com	東京都
城田 真悠子	shirota_mayuko@example.com	福島県
米倉 六郎	yonekura_rokurou@example.com	北海道
正木 貴嶺	masaki_takane@example.com	広島県
倉本 里穂	kuramoto_riho@example.com	兵庫県
馬場 莉緒	baba_rio@example.com	長野県
山元 蒼甫	yamamoto_sousuke@example.com	兵庫県
川中 貴美子	kawanaka_kimiko@example.com	山梨県
